PokerStars Hand #189156835809: Tournament #2361851754, 9000+1000 Hold'em No Limit - Level II (12/24) - 2018/07/25 20:20:17 ET
Table '2361851754 17' 9-max Seat #7 is the button
Seat 1: September Star (1284 in chips) 
Seat 2: hzane (1500 in chips) 
Seat 3: C.L.F.9 (1380 in chips) is sitting out
Seat 4: Volley562 (1500 in chips) 
Seat 5: wantacruise (1500 in chips) 
Seat 6: igloos65 (1476 in chips) 
Seat 7: Texas324 (1488 in chips) 
Seat 8: plomero487 (3252 in chips) 
plomero487: posts small blind 12
September Star: posts big blind 24
*** HOLE CARDS ***
Dealt to hzane [5d Ac]
hzane: calls 24
C.L.F.9: folds 
Volley562: folds 
wantacruise: folds 
igloos65: folds 
Texas324: calls 24
plomero487: calls 12
September Star: raises 24 to 48
hzane: calls 24
Texas324: calls 24
plomero487: calls 24
*** FLOP *** [4h 9c Qs]
plomero487: checks 
September Star: bets 24
hzane: calls 24
Texas324: calls 24
plomero487: calls 24
*** TURN *** [4h 9c Qs] [9d]
plomero487: checks 
September Star: bets 24
hzane: folds 
Texas324: calls 24
plomero487: raises 504 to 528
September Star: folds 
Texas324: folds 
Uncalled bet (504) returned to plomero487
plomero487 collected 360 from pot
plomero487: doesn't show hand 
*** SUMMARY ***
Total pot 360 | Rake 0 
Board [4h 9c Qs 9d]
Seat 1: September Star (big blind) folded on the Turn
Seat 2: hzane folded on the Turn
Seat 3: C.L.F.9 folded before Flop (didn't bet)
Seat 4: Volley562 folded before Flop (didn't bet)
Seat 5: wantacruise folded before Flop (didn't bet)
Seat 6: igloos65 folded before Flop (didn't bet)
Seat 7: Texas324 (button) folded on the Turn
Seat 8: plomero487 (small blind) collected (360)



PokerStars Hand #189156872238: Tournament #2361851754, 9000+1000 Hold'em No Limit - Level III (14/28) - 2018/07/25 20:21:45 ET
Table '2361851754 22' 9-max Seat #1 is the button
Seat 1: hzane (1428 in chips) 
Seat 2: jaircho72 (1410 in chips) 
Seat 3: jfehof (1036 in chips) 
Seat 4: LaFuras (1472 in chips) 
Seat 5: baked potatoes (1500 in chips) 
Seat 7: leebury1935 (1500 in chips) 
jaircho72: posts small blind 14
jfehof: posts big blind 28
*** HOLE CARDS ***
Dealt to hzane [4s 4d]
LaFuras is connected 
LaFuras: calls 28
baked potatoes: raises 98 to 126
leebury1935: calls 126
hzane: calls 126
jaircho72: folds 
jfehof: folds 
LaFuras: calls 98
*** FLOP *** [6c 8s 9d]
LaFuras: checks 
baked potatoes: bets 280
leebury1935: folds 
hzane: folds 
LaFuras: folds 
Uncalled bet (280) returned to baked potatoes
baked potatoes collected 546 from pot
baked potatoes: doesn't show hand 
*** SUMMARY ***
Total pot 546 | Rake 0 
Board [6c 8s 9d]
Seat 1: hzane (button) folded on the Flop
Seat 2: jaircho72 (small blind) folded before Flop
Seat 3: jfehof (big blind) folded before Flop
Seat 4: LaFuras folded on the Flop
Seat 5: baked potatoes collected (546)
Seat 7: leebury1935 folded on the Flop



PokerStars Hand #189156887153: Tournament #2361851754, 9000+1000 Hold'em No Limit - Level III (14/28) - 2018/07/25 20:22:21 ET
Table '2361851754 22' 9-max Seat #2 is the button
Seat 1: hzane (1302 in chips) 
Seat 2: jaircho72 (1396 in chips) 
Seat 3: jfehof (1008 in chips) 
Seat 4: LaFuras (1346 in chips) 
Seat 5: baked potatoes (1920 in chips) 
Seat 6: coribe22 (1524 in chips) 
Seat 7: leebury1935 (1374 in chips) 
Seat 8: fritz664 (1392 in chips) 
Seat 9: tonkatruck50 (1500 in chips) 
jfehof: posts small blind 14
LaFuras: posts big blind 28
*** HOLE CARDS ***
Dealt to hzane [3s 2c]
baked potatoes: folds 
coribe22: folds 
leebury1935: calls 28
fritz664: calls 28
tonkatruck50: calls 28
hzane: folds 
jaircho72: calls 28
jfehof: calls 14
LaFuras: checks 
*** FLOP *** [6h Js 7c]
jfehof: checks 
LaFuras: bets 28
leebury1935: calls 28
fritz664: folds 
tonkatruck50: calls 28
jaircho72: calls 28
jfehof: calls 28
*** TURN *** [6h Js 7c] [Kd]
jfehof: bets 952 and is all-in
LaFuras: raises 338 to 1290 and is all-in
leebury1935: folds 
tonkatruck50: folds 
jaircho72: folds 
Uncalled bet (338) returned to LaFuras
*** RIVER *** [6h Js 7c Kd] [6c]
*** SHOW DOWN ***
jfehof: shows [7h Jh] (two pair, Jacks and Sevens)
LaFuras: shows [8c Kc] (two pair, Kings and Sixes)
LaFuras collected 2212 from pot
jfehof finished the tournament
*** SUMMARY ***
Total pot 2212 | Rake 0 
Board [6h Js 7c Kd 6c]
Seat 1: hzane folded before Flop (didn't bet)
Seat 2: jaircho72 (button) folded on the Turn
Seat 3: jfehof (small blind) showed [7h Jh] and lost with two pair, Jacks and Sevens
Seat 4: LaFuras (big blind) showed [8c Kc] and won (2212) with two pair, Kings and Sixes
Seat 5: baked potatoes folded before Flop (didn't bet)
Seat 6: coribe22 folded before Flop (didn't bet)
Seat 7: leebury1935 folded on the Turn
Seat 8: fritz664 folded on the Flop
Seat 9: tonkatruck50 folded on the Turn



PokerStars Hand #189156915063: Tournament #2361851754, 9000+1000 Hold'em No Limit - Level III (14/28) - 2018/07/25 20:23:29 ET
Table '2361851754 22' 9-max Seat #4 is the button
Seat 1: hzane (1302 in chips) 
Seat 2: jaircho72 (1340 in chips) 
Seat 4: LaFuras (2550 in chips) 
Seat 5: baked potatoes (1920 in chips) 
Seat 6: coribe22 (1524 in chips) 
Seat 7: leebury1935 (1318 in chips) 
Seat 8: fritz664 (1364 in chips) 
Seat 9: tonkatruck50 (1444 in chips) 
baked potatoes: posts small blind 14
coribe22: posts big blind 28
*** HOLE CARDS ***
Dealt to hzane [8h 9h]
leebury1935: calls 28
fritz664: calls 28
tonkatruck50: calls 28
hzane: raises 28 to 56
jaircho72: folds 
LaFuras: calls 56
baked potatoes: calls 42
coribe22: calls 28
leebury1935: calls 28
fritz664: calls 28
tonkatruck50: calls 28
*** FLOP *** [4d Ac Kh]
baked potatoes: checks 
coribe22: checks 
leebury1935: bets 1262 and is all-in
fritz664: raises 46 to 1308 and is all-in
tonkatruck50: folds 
hzane: folds 
LaFuras: folds 
baked potatoes: folds 
coribe22: folds 
Uncalled bet (46) returned to fritz664
*** TURN *** [4d Ac Kh] [8s]
*** RIVER *** [4d Ac Kh 8s] [Js]
*** SHOW DOWN ***
leebury1935: shows [9s Ah] (a pair of Aces)
fritz664: shows [Th As] (a pair of Aces - King+Jack+Ten kicker)
fritz664 collected 2916 from pot
leebury1935 finished the tournament
*** SUMMARY ***
Total pot 2916 | Rake 0 
Board [4d Ac Kh 8s Js]
Seat 1: hzane folded on the Flop
Seat 2: jaircho72 folded before Flop (didn't bet)
Seat 4: LaFuras (button) folded on the Flop
Seat 5: baked potatoes (small blind) folded on the Flop
Seat 6: coribe22 (big blind) folded on the Flop
Seat 7: leebury1935 showed [9s Ah] and lost with a pair of Aces
Seat 8: fritz664 showed [Th As] and won (2916) with a pair of Aces
Seat 9: tonkatruck50 folded on the Flop



PokerStars Hand #189156938453: Tournament #2361851754, 9000+1000 Hold'em No Limit - Level IV (16/32) - 2018/07/25 20:24:26 ET
Table '2361851754 22' 9-max Seat #5 is the button
Seat 1: hzane (1246 in chips) 
Seat 2: jaircho72 (1340 in chips) 
Seat 3: luck ken (1500 in chips) 
Seat 4: LaFuras (2494 in chips) 
Seat 5: baked potatoes (1864 in chips) 
Seat 6: coribe22 (1468 in chips) 
Seat 9: tonkatruck50 (1388 in chips) 
coribe22: posts small blind 16
tonkatruck50: posts big blind 32
*** HOLE CARDS ***
Dealt to hzane [8h 7c]
hzane: folds 
jaircho72: calls 32
luck ken: folds 
LaFuras: calls 32
baked potatoes: calls 32
coribe22: raises 160 to 192
tonkatruck50: folds 
jaircho72: calls 160
LaFuras: folds 
baked potatoes: calls 160
*** FLOP *** [Jd 2c 3c]
coribe22: bets 320
jaircho72: calls 320
baked potatoes: calls 320
*** TURN *** [Jd 2c 3c] [6s]
coribe22: bets 956 and is all-in
jaircho72: folds 
baked potatoes: calls 956
*** RIVER *** [Jd 2c 3c 6s] [5s]
*** SHOW DOWN ***
coribe22: shows [Kd Kc] (a pair of Kings)
baked potatoes: shows [3h Ac] (a pair of Threes)
coribe22 collected 3512 from pot
*** SUMMARY ***
Total pot 3512 | Rake 0 
Board [Jd 2c 3c 6s 5s]
Seat 1: hzane folded before Flop (didn't bet)
Seat 2: jaircho72 folded on the Turn
Seat 3: luck ken folded before Flop (didn't bet)
Seat 4: LaFuras folded before Flop
Seat 5: baked potatoes (button) showed [3h Ac] and lost with a pair of Threes
Seat 6: coribe22 (small blind) showed [Kd Kc] and won (3512) with a pair of Kings
Seat 9: tonkatruck50 (big blind) folded before Flop



PokerStars Hand #189156957582: Tournament #2361851754, 9000+1000 Hold'em No Limit - Level IV (16/32) - 2018/07/25 20:25:11 ET
Table '2361851754 22' 9-max Seat #6 is the button
Seat 1: hzane (1246 in chips) 
Seat 2: jaircho72 (828 in chips) 
Seat 3: luck ken (1500 in chips) 
Seat 4: LaFuras (2462 in chips) 
Seat 5: baked potatoes (396 in chips) 
Seat 6: coribe22 (3512 in chips) 
Seat 9: tonkatruck50 (1356 in chips) 
tonkatruck50: posts small blind 16
hzane: posts big blind 32
*** HOLE CARDS ***
Dealt to hzane [5h Jh]
jaircho72: folds 
luck ken: calls 32
LaFuras: calls 32
baked potatoes: raises 364 to 396 and is all-in
coribe22: calls 396
tonkatruck50: folds 
hzane: calls 364
luck ken: calls 364
LaFuras: folds 
*** FLOP *** [Ac 3h Qh]
hzane: bets 32
luck ken: raises 768 to 800
coribe22: calls 800
hzane: raises 50 to 850 and is all-in
luck ken: calls 50
coribe22: calls 50
*** TURN *** [Ac 3h Qh] [Qd]
luck ken: bets 254 and is all-in
coribe22: calls 254
*** RIVER *** [Ac 3h Qh Qd] [2h]
*** SHOW DOWN ***
luck ken: shows [Ad 5s] (two pair, Aces and Queens)
coribe22: shows [8h 7h] (a flush, Queen high)
coribe22 collected 508 from side pot-2 
hzane: shows [5h Jh] (a flush, Queen high - Jack higher)
hzane collected 2550 from side pot-1 
baked potatoes: shows [Js 8d] (a pair of Queens)
hzane collected 1632 from main pot
luck ken finished the tournament
baked potatoes finished the tournament
*** SUMMARY ***
Total pot 4690 Main pot 1632. Side pot-1 2550. Side pot-2 508. | Rake 0 
Board [Ac 3h Qh Qd 2h]
Seat 1: hzane (big blind) showed [5h Jh] and won (4182) with a flush, Queen high
Seat 2: jaircho72 folded before Flop (didn't bet)
Seat 3: luck ken showed [Ad 5s] and lost with two pair, Aces and Queens
Seat 4: LaFuras folded before Flop
Seat 5: baked potatoes showed [Js 8d] and lost with a pair of Queens
Seat 6: coribe22 (button) showed [8h 7h] and won (508) with a flush, Queen high
Seat 9: tonkatruck50 (small blind) folded before Flop



PokerStars Hand #189156982100: Tournament #2361851754, 9000+1000 Hold'em No Limit - Level IV (16/32) - 2018/07/25 20:26:12 ET
Table '2361851754 22' 9-max Seat #9 is the button
Seat 1: hzane (4182 in chips) 
Seat 2: jaircho72 (828 in chips) 
Seat 4: LaFuras (2430 in chips) 
Seat 6: coribe22 (2520 in chips) 
Seat 7: Don´t surrender (1500 in chips) 
Seat 8: gimpy464 (1500 in chips) 
Seat 9: tonkatruck50 (1340 in chips) 
hzane: posts small blind 16
jaircho72: posts big blind 32
*** HOLE CARDS ***
Dealt to hzane [8s 8h]
LaFuras: calls 32
coribe22: folds 
Don´t surrender: raises 32 to 64
gimpy464: folds 
tonkatruck50: calls 64
hzane: calls 48
jaircho72: calls 32
LaFuras: calls 32
*** FLOP *** [Qh As Jd]
hzane: checks 
jaircho72: checks 
LaFuras: checks 
Don´t surrender: checks 
tonkatruck50: bets 160
hzane: folds 
jaircho72: folds 
LaFuras: calls 160
Don´t surrender: folds 
*** TURN *** [Qh As Jd] [2d]
LaFuras: checks 
tonkatruck50: bets 160
LaFuras: calls 160
*** RIVER *** [Qh As Jd 2d] [6c]
LaFuras: bets 296
tonkatruck50: folds 
Uncalled bet (296) returned to LaFuras
LaFuras collected 960 from pot
LaFuras: doesn't show hand 
*** SUMMARY ***
Total pot 960 | Rake 0 
Board [Qh As Jd 2d 6c]
Seat 1: hzane (small blind) folded on the Flop
Seat 2: jaircho72 (big blind) folded on the Flop
Seat 4: LaFuras collected (960)
Seat 6: coribe22 folded before Flop (didn't bet)
Seat 7: Don´t surrender folded on the Flop
Seat 8: gimpy464 folded before Flop (didn't bet)
Seat 9: tonkatruck50 (button) folded on the River



PokerStars Hand #189157013712: Tournament #2361851754, 9000+1000 Hold'em No Limit - Level V (20/40) - 2018/07/25 20:27:30 ET
Table '2361851754 22' 9-max Seat #1 is the button
Seat 1: hzane (4118 in chips) 
Seat 2: jaircho72 (764 in chips) 
Seat 3: blaacksta (1408 in chips) 
Seat 4: LaFuras (3006 in chips) 
Seat 5: amejose (1500 in chips) 
Seat 6: coribe22 (2520 in chips) 
Seat 7: Don´t surrender (1436 in chips) 
Seat 8: gimpy464 (1500 in chips) 
Seat 9: tonkatruck50 (956 in chips) 
hzane: posts the ante 4
jaircho72: posts the ante 4
blaacksta: posts the ante 4
LaFuras: posts the ante 4
amejose: posts the ante 4
coribe22: posts the ante 4
Don´t surrender: posts the ante 4
gimpy464: posts the ante 4
tonkatruck50: posts the ante 4
jaircho72: posts small blind 20
blaacksta: posts big blind 40
*** HOLE CARDS ***
Dealt to hzane [Ah Qs]
LaFuras: folds 
amejose: calls 40
coribe22: calls 40
Don´t surrender: calls 40
gimpy464: folds 
tonkatruck50: raises 40 to 80
hzane: raises 80 to 160
jaircho72: calls 140
blaacksta: folds 
amejose: calls 120
coribe22: calls 120
Don´t surrender: calls 120
tonkatruck50: raises 792 to 952 and is all-in
hzane: calls 792
jaircho72: calls 600 and is all-in
amejose: folds 
coribe22: folds 
Don´t surrender: calls 792
*** FLOP *** [Js 5s Kh]
Don´t surrender: checks 
hzane: checks 
*** TURN *** [Js 5s Kh] [Qh]
Don´t surrender: checks 
hzane: bets 120
Don´t surrender: calls 120
*** RIVER *** [Js 5s Kh Qh] [Jh]
Don´t surrender: checks 
hzane: checks 
*** SHOW DOWN ***
Don´t surrender: shows [9h 6h] (a flush, King high)
hzane: mucks hand 
Don´t surrender collected 240 from side pot-2 
tonkatruck50: mucks hand 
Don´t surrender collected 576 from side pot-1 
jaircho72: mucks hand 
Don´t surrender collected 3436 from main pot
tonkatruck50 finished the tournament
jaircho72 finished the tournament
*** SUMMARY ***
Total pot 4252 Main pot 3436. Side pot-1 576. Side pot-2 240. | Rake 0 
Board [Js 5s Kh Qh Jh]
Seat 1: hzane (button) mucked [Ah Qs]
Seat 2: jaircho72 (small blind) mucked [Ac 5c]
Seat 3: blaacksta (big blind) folded before Flop
Seat 4: LaFuras folded before Flop (didn't bet)
Seat 5: amejose folded before Flop
Seat 6: coribe22 folded before Flop
Seat 7: Don´t surrender showed [9h 6h] and won (4252) with a flush, King high
Seat 8: gimpy464 folded before Flop (didn't bet)
Seat 9: tonkatruck50 mucked [As 3h]



PokerStars Hand #189157055363: Tournament #2361851754, 9000+1000 Hold'em No Limit - Level V (20/40) - 2018/07/25 20:29:12 ET
Table '2361851754 22' 9-max Seat #3 is the button
Seat 1: hzane (3042 in chips) 
Seat 3: blaacksta (1364 in chips) 
Seat 4: LaFuras (3002 in chips) 
Seat 5: amejose (1336 in chips) 
Seat 6: coribe22 (2356 in chips) 
Seat 7: Don´t surrender (4612 in chips) 
Seat 8: gimpy464 (1496 in chips) 
Seat 9: yedamoca (3124 in chips) 
hzane: posts the ante 4
blaacksta: posts the ante 4
LaFuras: posts the ante 4
amejose: posts the ante 4
coribe22: posts the ante 4
Don´t surrender: posts the ante 4
gimpy464: posts the ante 4
yedamoca: posts the ante 4
LaFuras: posts small blind 20
amejose: posts big blind 40
*** HOLE CARDS ***
Dealt to hzane [Td 4c]
coribe22: folds 
Don´t surrender: calls 40
gimpy464: folds 
yedamoca: folds 
hzane: folds 
blaacksta: folds 
LaFuras: calls 20
amejose has timed out
amejose: checks 
*** FLOP *** [Jh 6s 8h]
LaFuras: checks 
amejose: bets 40
Don´t surrender: folds 
LaFuras: calls 40
*** TURN *** [Jh 6s 8h] [7d]
LaFuras: bets 318
amejose: calls 318
*** RIVER *** [Jh 6s 8h 7d] [Kc]
LaFuras: bets 600
amejose: folds 
Uncalled bet (600) returned to LaFuras
LaFuras collected 868 from pot
LaFuras: doesn't show hand 
*** SUMMARY ***
Total pot 868 | Rake 0 
Board [Jh 6s 8h 7d Kc]
Seat 1: hzane folded before Flop (didn't bet)
Seat 3: blaacksta (button) folded before Flop (didn't bet)
Seat 4: LaFuras (small blind) collected (868)
Seat 5: amejose (big blind) folded on the River
Seat 6: coribe22 folded before Flop (didn't bet)
Seat 7: Don´t surrender folded on the Flop
Seat 8: gimpy464 folded before Flop (didn't bet)
Seat 9: yedamoca folded before Flop (didn't bet)



PokerStars Hand #189157087827: Tournament #2361851754, 9000+1000 Hold'em No Limit - Level VI (25/50) - 2018/07/25 20:30:32 ET
Table '2361851754 22' 9-max Seat #4 is the button
Seat 1: hzane (3038 in chips) 
Seat 2: MikeVin100 (1500 in chips) 
Seat 3: blaacksta (1360 in chips) 
Seat 4: LaFuras (3468 in chips) 
Seat 5: amejose (934 in chips) 
Seat 7: Don´t surrender (4568 in chips) 
Seat 8: gimpy464 (1492 in chips) 
Seat 9: yedamoca (3120 in chips) 
hzane: posts the ante 5
MikeVin100: posts the ante 5
blaacksta: posts the ante 5
LaFuras: posts the ante 5
amejose: posts the ante 5
Don´t surrender: posts the ante 5
gimpy464: posts the ante 5
yedamoca: posts the ante 5
amejose: posts small blind 25
Don´t surrender: posts big blind 50
*** HOLE CARDS ***
Dealt to hzane [6c 3d]
gimpy464: calls 50
yedamoca: calls 50
hzane: folds 
MikeVin100: folds 
blaacksta: calls 50
LaFuras: calls 50
amejose: calls 25
Don´t surrender: checks 
*** FLOP *** [3c 9c Qs]
amejose: checks 
Don´t surrender: bets 50
gimpy464: calls 50
yedamoca: folds 
blaacksta: folds 
LaFuras: calls 50
amejose: folds 
*** TURN *** [3c 9c Qs] [2c]
Don´t surrender: checks 
gimpy464: checks 
LaFuras: checks 
*** RIVER *** [3c 9c Qs 2c] [5s]
Don´t surrender: checks 
gimpy464: checks 
LaFuras: bets 363
Don´t surrender: folds 
gimpy464: calls 363
*** SHOW DOWN ***
LaFuras: shows [Td Ad] (high card Ace)
gimpy464: shows [Kh Kd] (a pair of Kings)
gimpy464 collected 1216 from pot
*** SUMMARY ***
Total pot 1216 | Rake 0 
Board [3c 9c Qs 2c 5s]
Seat 1: hzane folded before Flop (didn't bet)
Seat 2: MikeVin100 folded before Flop (didn't bet)
Seat 3: blaacksta folded on the Flop
Seat 4: LaFuras (button) showed [Td Ad] and lost with high card Ace
Seat 5: amejose (small blind) folded on the Flop
Seat 7: Don´t surrender (big blind) folded on the River
Seat 8: gimpy464 showed [Kh Kd] and won (1216) with a pair of Kings
Seat 9: yedamoca folded on the Flop



PokerStars Hand #189157120851: Tournament #2361851754, 9000+1000 Hold'em No Limit - Level VI (25/50) - 2018/07/25 20:31:31 ET
Table '2361851754 22' 9-max Seat #5 is the button
Seat 1: hzane (3033 in chips) 
Seat 2: MikeVin100 (1495 in chips) 
Seat 3: blaacksta (1305 in chips) 
Seat 4: LaFuras (3000 in chips) 
Seat 5: amejose (879 in chips) 
Seat 7: Don´t surrender (4463 in chips) 
Seat 8: gimpy464 (2240 in chips) 
Seat 9: yedamoca (3065 in chips) 
hzane: posts the ante 5
MikeVin100: posts the ante 5
blaacksta: posts the ante 5
LaFuras: posts the ante 5
amejose: posts the ante 5
Don´t surrender: posts the ante 5
gimpy464: posts the ante 5
yedamoca: posts the ante 5
Don´t surrender: posts small blind 25
gimpy464: posts big blind 50
*** HOLE CARDS ***
Dealt to hzane [Qd 2c]
yedamoca: folds 
hzane: folds 
MikeVin100: folds 
blaacksta: folds 
LaFuras: calls 50
amejose: calls 50
Don´t surrender: calls 25
gimpy464: checks 
*** FLOP *** [2s 3h 9d]
Don´t surrender: checks 
gimpy464: checks 
LaFuras: checks 
amejose: bets 200
Don´t surrender: folds 
gimpy464: folds 
LaFuras: folds 
Uncalled bet (200) returned to amejose
amejose collected 240 from pot
*** SUMMARY ***
Total pot 240 | Rake 0 
Board [2s 3h 9d]
Seat 1: hzane folded before Flop (didn't bet)
Seat 2: MikeVin100 folded before Flop (didn't bet)
Seat 3: blaacksta folded before Flop (didn't bet)
Seat 4: LaFuras folded on the Flop
Seat 5: amejose (button) collected (240)
Seat 7: Don´t surrender (small blind) folded on the Flop
Seat 8: gimpy464 (big blind) folded on the Flop
Seat 9: yedamoca folded before Flop (didn't bet)



PokerStars Hand #189157137371: Tournament #2361851754, 9000+1000 Hold'em No Limit - Level VI (25/50) - 2018/07/25 20:32:12 ET
Table '2361851754 22' 9-max Seat #7 is the button
Seat 1: hzane (3028 in chips) 
Seat 3: blaacksta (1300 in chips) 
Seat 4: LaFuras (2945 in chips) 
Seat 5: amejose (1064 in chips) 
Seat 6: Th_n88 (1500 in chips) 
Seat 7: Don´t surrender (4408 in chips) 
Seat 8: gimpy464 (2185 in chips) 
Seat 9: yedamoca (3060 in chips) 
hzane: posts the ante 5
blaacksta: posts the ante 5
LaFuras: posts the ante 5
amejose: posts the ante 5
Th_n88: posts the ante 5
Don´t surrender: posts the ante 5
gimpy464: posts the ante 5
yedamoca: posts the ante 5
gimpy464: posts small blind 25
yedamoca: posts big blind 50
*** HOLE CARDS ***
Dealt to hzane [5c Qc]
hzane: calls 50
blaacksta: calls 50
LaFuras: calls 50
amejose: raises 300 to 350
Th_n88: calls 350
Don´t surrender: calls 350
gimpy464: folds 
yedamoca: folds 
hzane: calls 300
blaacksta: folds 
LaFuras: folds 
*** FLOP *** [2h 6s Kd]
hzane: bets 350
amejose: raises 359 to 709 and is all-in
Th_n88 has timed out
Th_n88: folds 
Don´t surrender: folds 
hzane: folds 
Uncalled bet (359) returned to amejose
amejose collected 2315 from pot
amejose: doesn't show hand 
*** SUMMARY ***
Total pot 2315 | Rake 0 
Board [2h 6s Kd]
Seat 1: hzane folded on the Flop
Seat 3: blaacksta folded before Flop
Seat 4: LaFuras folded before Flop
Seat 5: amejose collected (2315)
Seat 6: Th_n88 folded on the Flop
Seat 7: Don´t surrender (button) folded on the Flop
Seat 8: gimpy464 (small blind) folded before Flop
Seat 9: yedamoca (big blind) folded before Flop



PokerStars Hand #189157168451: Tournament #2361851754, 9000+1000 Hold'em No Limit - Level VII (30/60) - 2018/07/25 20:33:30 ET
Table '2361851754 22' 9-max Seat #8 is the button
Seat 1: hzane (2323 in chips) 
Seat 2: Hugo Martpen (1500 in chips) 
Seat 3: blaacksta (1245 in chips) 
Seat 4: LaFuras (2890 in chips) 
Seat 6: Th_n88 (1145 in chips) is sitting out
Seat 7: Don´t surrender (4053 in chips) 
Seat 8: gimpy464 (2155 in chips) is sitting out
Seat 9: yedamoca (3005 in chips) 
hzane: posts the ante 6
Hugo Martpen: posts the ante 6
blaacksta: posts the ante 6
LaFuras: posts the ante 6
Th_n88: posts the ante 6
Don´t surrender: posts the ante 6
gimpy464: posts the ante 6
yedamoca: posts the ante 6
yedamoca: posts small blind 30
hzane: posts big blind 60
*** HOLE CARDS ***
Dealt to hzane [7d Ks]
Hugo Martpen: folds 
blaacksta: raises 60 to 120
LaFuras: folds 
Th_n88: folds 
Don´t surrender: folds 
gimpy464: folds 
yedamoca: calls 90
hzane: calls 60
*** FLOP *** [As 4s 3h]
yedamoca: checks 
hzane: checks 
blaacksta: bets 135
yedamoca: calls 135
hzane: calls 135
*** TURN *** [As 4s 3h] [8s]
yedamoca: checks 
hzane: bets 240
blaacksta: folds 
yedamoca: calls 240
*** RIVER *** [As 4s 3h 8s] [3d]
yedamoca: checks 
hzane: bets 720
yedamoca: folds 
Uncalled bet (720) returned to hzane
hzane collected 1293 from pot
*** SUMMARY ***
Total pot 1293 | Rake 0 
Board [As 4s 3h 8s 3d]
Seat 1: hzane (big blind) collected (1293)
Seat 2: Hugo Martpen folded before Flop (didn't bet)
Seat 3: blaacksta folded on the Turn
Seat 4: LaFuras folded before Flop (didn't bet)
Seat 6: Th_n88 folded before Flop (didn't bet)
Seat 7: Don´t surrender folded before Flop (didn't bet)
Seat 8: gimpy464 (button) folded before Flop (didn't bet)
Seat 9: yedamoca (small blind) folded on the River



PokerStars Hand #189157190426: Tournament #2361851754, 9000+1000 Hold'em No Limit - Level VII (30/60) - 2018/07/25 20:34:26 ET
Table '2361851754 22' 9-max Seat #9 is the button
Seat 1: hzane (3115 in chips) 
Seat 2: Hugo Martpen (1494 in chips) 
Seat 3: blaacksta (984 in chips) 
Seat 4: LaFuras (2884 in chips) 
Seat 5: uncle g unit (1500 in chips) 
Seat 6: Th_n88 (1139 in chips) is sitting out
Seat 7: Don´t surrender (4047 in chips) 
Seat 8: gimpy464 (2149 in chips) is sitting out
Seat 9: yedamoca (2504 in chips) 
hzane: posts the ante 6
Hugo Martpen: posts the ante 6
blaacksta: posts the ante 6
LaFuras: posts the ante 6
uncle g unit: posts the ante 6
Th_n88: posts the ante 6
Don´t surrender: posts the ante 6
gimpy464: posts the ante 6
yedamoca: posts the ante 6
hzane: posts small blind 30
Hugo Martpen: posts big blind 60
*** HOLE CARDS ***
Dealt to hzane [8s 5d]
blaacksta: folds 
LaFuras: folds 
uncle g unit: folds 
Th_n88: folds 
Don´t surrender: calls 60
gimpy464: folds 
yedamoca: folds 
hzane: folds 
Hugo Martpen: checks 
*** FLOP *** [Ts Jc Qc]
Hugo Martpen: bets 60
Don´t surrender: calls 60
*** TURN *** [Ts Jc Qc] [Tc]
Hugo Martpen: bets 180
Don´t surrender: folds 
Uncalled bet (180) returned to Hugo Martpen
Hugo Martpen collected 324 from pot
Hugo Martpen: doesn't show hand 
*** SUMMARY ***
Total pot 324 | Rake 0 
Board [Ts Jc Qc Tc]
Seat 1: hzane (small blind) folded before Flop
Seat 2: Hugo Martpen (big blind) collected (324)
Seat 3: blaacksta folded before Flop (didn't bet)
Seat 4: LaFuras folded before Flop (didn't bet)
Seat 5: uncle g unit folded before Flop (didn't bet)
Seat 6: Th_n88 folded before Flop (didn't bet)
Seat 7: Don´t surrender folded on the Turn
Seat 8: gimpy464 folded before Flop (didn't bet)
Seat 9: yedamoca (button) folded before Flop (didn't bet)



PokerStars Hand #189157204971: Tournament #2361851754, 9000+1000 Hold'em No Limit - Level VII (30/60) - 2018/07/25 20:35:03 ET
Table '2361851754 22' 9-max Seat #1 is the button
Seat 1: hzane (3079 in chips) 
Seat 2: Hugo Martpen (1692 in chips) 
Seat 3: blaacksta (978 in chips) 
Seat 4: LaFuras (2878 in chips) 
Seat 5: uncle g unit (1494 in chips) 
Seat 7: Don´t surrender (3921 in chips) 
Seat 8: gimpy464 (2143 in chips) is sitting out
Seat 9: yedamoca (2498 in chips) 
hzane: posts the ante 6
Hugo Martpen: posts the ante 6
blaacksta: posts the ante 6
LaFuras: posts the ante 6
uncle g unit: posts the ante 6
Don´t surrender: posts the ante 6
gimpy464: posts the ante 6
yedamoca: posts the ante 6
Hugo Martpen: posts small blind 30
blaacksta: posts big blind 60
*** HOLE CARDS ***
Dealt to hzane [5d Kc]
LaFuras: calls 60
uncle g unit: calls 60
Don´t surrender: calls 60
gimpy464: folds 
yedamoca: folds 
hzane: calls 60
Hugo Martpen: calls 30
blaacksta: checks 
*** FLOP *** [2c Th Kh]
Hugo Martpen: checks 
blaacksta: checks 
LaFuras: bets 312
uncle g unit: calls 312
Don´t surrender has timed out
Don´t surrender: folds 
hzane: calls 312
Hugo Martpen: folds 
blaacksta: folds 
*** TURN *** [2c Th Kh] [2d]
LaFuras: bets 500
uncle g unit: calls 500
hzane: calls 500
*** RIVER *** [2c Th Kh 2d] [5s]
LaFuras: bets 750
uncle g unit: folds 
hzane: raises 750 to 1500
LaFuras: calls 750
*** SHOW DOWN ***
hzane: shows [5d Kc] (two pair, Kings and Fives)
LaFuras: mucks hand 
hzane collected 5844 from pot
*** SUMMARY ***
Total pot 5844 | Rake 0 
Board [2c Th Kh 2d 5s]
Seat 1: hzane (button) showed [5d Kc] and won (5844) with two pair, Kings and Fives
Seat 2: Hugo Martpen (small blind) folded on the Flop
Seat 3: blaacksta (big blind) folded on the Flop
Seat 4: LaFuras mucked [Ks Qh]
Seat 5: uncle g unit folded on the River
Seat 7: Don´t surrender folded on the Flop
Seat 8: gimpy464 folded before Flop (didn't bet)
Seat 9: yedamoca folded before Flop (didn't bet)



PokerStars Hand #189157243572: Tournament #2361851754, 9000+1000 Hold'em No Limit - Level VIII (35/70) - 2018/07/25 20:36:39 ET
Table '2361851754 22' 9-max Seat #2 is the button
Seat 1: hzane (6545 in chips) 
Seat 2: Hugo Martpen (1626 in chips) 
Seat 3: blaacksta (912 in chips) 
Seat 4: LaFuras (500 in chips) 
Seat 5: uncle g unit (616 in chips) 
Seat 6: dynadude1 (3259 in chips) 
Seat 7: Don´t surrender (3855 in chips) 
Seat 8: gimpy464 (2137 in chips) is sitting out
Seat 9: yedamoca (2492 in chips) 
hzane: posts the ante 7
Hugo Martpen: posts the ante 7
blaacksta: posts the ante 7
LaFuras: posts the ante 7
uncle g unit: posts the ante 7
dynadude1: posts the ante 7
Don´t surrender: posts the ante 7
gimpy464: posts the ante 7
yedamoca: posts the ante 7
blaacksta: posts small blind 35
LaFuras: posts big blind 70
*** HOLE CARDS ***
Dealt to hzane [3d 3c]
uncle g unit: raises 539 to 609 and is all-in
dynadude1: folds 
Don´t surrender: folds 
gimpy464: folds 
yedamoca: calls 609
hzane: folds 
Hugo Martpen: folds 
blaacksta: folds 
LaFuras: folds 
*** FLOP *** [Jd 9s 7s]
*** TURN *** [Jd 9s 7s] [6c]
*** RIVER *** [Jd 9s 7s 6c] [2s]
*** SHOW DOWN ***
uncle g unit: shows [Jh Qs] (a pair of Jacks)
yedamoca: shows [Td 9d] (a pair of Nines)
uncle g unit collected 1386 from pot
*** SUMMARY ***
Total pot 1386 | Rake 0 
Board [Jd 9s 7s 6c 2s]
Seat 1: hzane folded before Flop (didn't bet)
Seat 2: Hugo Martpen (button) folded before Flop (didn't bet)
Seat 3: blaacksta (small blind) folded before Flop
Seat 4: LaFuras (big blind) folded before Flop
Seat 5: uncle g unit showed [Jh Qs] and won (1386) with a pair of Jacks
Seat 6: dynadude1 folded before Flop (didn't bet)
Seat 7: Don´t surrender folded before Flop (didn't bet)
Seat 8: gimpy464 folded before Flop (didn't bet)
Seat 9: yedamoca showed [Td 9d] and lost with a pair of Nines



PokerStars Hand #189157256471: Tournament #2361851754, 9000+1000 Hold'em No Limit - Level VIII (35/70) - 2018/07/25 20:37:11 ET
Table '2361851754 22' 9-max Seat #3 is the button
Seat 1: hzane (6538 in chips) 
Seat 2: Hugo Martpen (1619 in chips) 
Seat 3: blaacksta (870 in chips) 
Seat 4: LaFuras (423 in chips) 
Seat 5: uncle g unit (1386 in chips) 
Seat 6: dynadude1 (3252 in chips) 
Seat 7: Don´t surrender (3848 in chips) 
Seat 8: gimpy464 (2130 in chips) is sitting out
Seat 9: yedamoca (1876 in chips) 
hzane: posts the ante 7
Hugo Martpen: posts the ante 7
blaacksta: posts the ante 7
LaFuras: posts the ante 7
uncle g unit: posts the ante 7
dynadude1: posts the ante 7
Don´t surrender: posts the ante 7
gimpy464: posts the ante 7
yedamoca: posts the ante 7
LaFuras: posts small blind 35
uncle g unit: posts big blind 70
*** HOLE CARDS ***
Dealt to hzane [5s 4h]
dynadude1: folds 
Don´t surrender: folds 
gimpy464: folds 
yedamoca: folds 
hzane: folds 
Hugo Martpen: calls 70
blaacksta: calls 70
LaFuras: raises 346 to 416 and is all-in
uncle g unit: folds 
Hugo Martpen: folds 
blaacksta: calls 346
*** FLOP *** [3c Kc 2d]
*** TURN *** [3c Kc 2d] [Jc]
*** RIVER *** [3c Kc 2d Jc] [7s]
*** SHOW DOWN ***
LaFuras: shows [2s Ad] (a pair of Deuces)
blaacksta: shows [7d 6c] (a pair of Sevens)
blaacksta collected 1035 from pot
LaFuras finished the tournament in 313th place
*** SUMMARY ***
Total pot 1035 | Rake 0 
Board [3c Kc 2d Jc 7s]
Seat 1: hzane folded before Flop (didn't bet)
Seat 2: Hugo Martpen folded before Flop
Seat 3: blaacksta (button) showed [7d 6c] and won (1035) with a pair of Sevens
Seat 4: LaFuras (small blind) showed [2s Ad] and lost with a pair of Deuces
Seat 5: uncle g unit (big blind) folded before Flop
Seat 6: dynadude1 folded before Flop (didn't bet)
Seat 7: Don´t surrender folded before Flop (didn't bet)
Seat 8: gimpy464 folded before Flop (didn't bet)
Seat 9: yedamoca folded before Flop (didn't bet)



PokerStars Hand #189157271315: Tournament #2361851754, 9000+1000 Hold'em No Limit - Level VIII (35/70) - 2018/07/25 20:37:49 ET
Table '2361851754 22' 9-max Seat #5 is the button
Seat 1: hzane (6531 in chips) 
Seat 2: Hugo Martpen (1542 in chips) 
Seat 3: blaacksta (1482 in chips) 
Seat 5: uncle g unit (1309 in chips) 
Seat 6: dynadude1 (3245 in chips) 
Seat 7: Don´t surrender (3841 in chips) 
Seat 8: gimpy464 (2123 in chips) 
Seat 9: yedamoca (1869 in chips) 
hzane: posts the ante 7
Hugo Martpen: posts the ante 7
blaacksta: posts the ante 7
uncle g unit: posts the ante 7
dynadude1: posts the ante 7
Don´t surrender: posts the ante 7
gimpy464: posts the ante 7
yedamoca: posts the ante 7
dynadude1: posts small blind 35
Don´t surrender: posts big blind 70
*** HOLE CARDS ***
Dealt to hzane [7h 6s]
gimpy464: folds 
yedamoca: calls 70
hzane: calls 70
Hugo Martpen: folds 
blaacksta: folds 
uncle g unit: folds 
dynadude1: calls 35
Don´t surrender: checks 
*** FLOP *** [As Qd Ks]
dynadude1: checks 
Don´t surrender: checks 
yedamoca: checks 
hzane: checks 
*** TURN *** [As Qd Ks] [3d]
dynadude1: bets 70
Don´t surrender: calls 70
yedamoca: folds 
hzane: folds 
*** RIVER *** [As Qd Ks 3d] [4d]
dynadude1: bets 70
Don´t surrender: calls 70
*** SHOW DOWN ***
dynadude1: shows [5c Ad] (a pair of Aces)
Don´t surrender: mucks hand 
dynadude1 collected 616 from pot
*** SUMMARY ***
Total pot 616 | Rake 0 
Board [As Qd Ks 3d 4d]
Seat 1: hzane folded on the Turn
Seat 2: Hugo Martpen folded before Flop (didn't bet)
Seat 3: blaacksta folded before Flop (didn't bet)
Seat 5: uncle g unit (button) folded before Flop (didn't bet)
Seat 6: dynadude1 (small blind) showed [5c Ad] and won (616) with a pair of Aces
Seat 7: Don´t surrender (big blind) mucked [Kc 7c]
Seat 8: gimpy464 folded before Flop (didn't bet)
Seat 9: yedamoca folded on the Turn



PokerStars Hand #189157288826: Tournament #2361851754, 9000+1000 Hold'em No Limit - Level VIII (35/70) - 2018/07/25 20:38:33 ET
Table '2361851754 22' 9-max Seat #6 is the button
Seat 1: hzane (6454 in chips) 
Seat 2: Hugo Martpen (1535 in chips) 
Seat 3: blaacksta (1475 in chips) 
Seat 4: bajjake (1266 in chips) 
Seat 5: uncle g unit (1302 in chips) 
Seat 6: dynadude1 (3644 in chips) 
Seat 7: Don´t surrender (3624 in chips) 
Seat 8: gimpy464 (2116 in chips) 
Seat 9: yedamoca (1792 in chips) 
hzane: posts the ante 7
Hugo Martpen: posts the ante 7
blaacksta: posts the ante 7
bajjake: posts the ante 7
uncle g unit: posts the ante 7
dynadude1: posts the ante 7
Don´t surrender: posts the ante 7
gimpy464: posts the ante 7
yedamoca: posts the ante 7
Don´t surrender: posts small blind 35
gimpy464: posts big blind 70
*** HOLE CARDS ***
Dealt to hzane [Qd Qs]
yedamoca: calls 70
hzane: raises 140 to 210
Hugo Martpen: folds 
blaacksta: calls 210
bajjake: folds 
uncle g unit: folds 
dynadude1: folds 
Don´t surrender: calls 175
gimpy464: folds 
yedamoca: calls 140
*** FLOP *** [Jd Qc Ac]
Don´t surrender: checks 
yedamoca: bets 1575 and is all-in
hzane: calls 1575
blaacksta: folds 
Don´t surrender: folds 
*** TURN *** [Jd Qc Ac] [Tc]
*** RIVER *** [Jd Qc Ac Tc] [Td]
*** SHOW DOWN ***
yedamoca: shows [Ah 6c] (two pair, Aces and Tens)
hzane: shows [Qd Qs] (a full house, Queens full of Tens)
hzane collected 4123 from pot
yedamoca finished the tournament in 289th place
*** SUMMARY ***
Total pot 4123 | Rake 0 
Board [Jd Qc Ac Tc Td]
Seat 1: hzane showed [Qd Qs] and won (4123) with a full house, Queens full of Tens
Seat 2: Hugo Martpen folded before Flop (didn't bet)
Seat 3: blaacksta folded on the Flop
Seat 4: bajjake folded before Flop (didn't bet)
Seat 5: uncle g unit folded before Flop (didn't bet)
Seat 6: dynadude1 (button) folded before Flop (didn't bet)
Seat 7: Don´t surrender (small blind) folded on the Flop
Seat 8: gimpy464 (big blind) folded before Flop
Seat 9: yedamoca showed [Ah 6c] and lost with two pair, Aces and Tens



PokerStars Hand #189157316025: Tournament #2361851754, 9000+1000 Hold'em No Limit - Level IX (40/80) - 2018/07/25 20:39:41 ET
Table '2361851754 35' 9-max Seat #9 is the button
Seat 1: Ricapj (1373 in chips) 
Seat 2: mateuspsb (1572 in chips) 
Seat 3: king007five (970 in chips) 
Seat 4: Targino33 (2859 in chips) 
Seat 5: 2BeSassy (1800 in chips) 
Seat 6: elmillu (1001 in chips) 
Seat 7: anita830 (2525 in chips) 
Seat 8: hzane (8785 in chips) 
Seat 9: ricefarmer1570 (1271 in chips) 
Ricapj: posts the ante 8
mateuspsb: posts the ante 8
king007five: posts the ante 8
Targino33: posts the ante 8
2BeSassy: posts the ante 8
elmillu: posts the ante 8
anita830: posts the ante 8
hzane: posts the ante 8
ricefarmer1570: posts the ante 8
Ricapj: posts small blind 40
mateuspsb: posts big blind 80
*** HOLE CARDS ***
Dealt to hzane [Ac Ad]
king007five: folds 
Targino33: calls 80
2BeSassy: folds 
elmillu: folds 
anita830: calls 80
hzane: raises 160 to 240
ricefarmer1570: raises 1023 to 1263 and is all-in
Ricapj: raises 102 to 1365 and is all-in
mateuspsb: raises 199 to 1564 and is all-in
Targino33: folds 
anita830: folds 
hzane: calls 1324
*** FLOP *** [Qd 4c Kd]
*** TURN *** [Qd 4c Kd] [5h]
*** RIVER *** [Qd 4c Kd 5h] [7d]
*** SHOW DOWN ***
mateuspsb: shows [Qh Th] (a pair of Queens)
hzane: shows [Ac Ad] (a pair of Aces)
hzane collected 398 from side pot-2 
Ricapj: shows [6d 2d] (a flush, King high)
Ricapj collected 306 from side pot-1 
ricefarmer1570: shows [9h 9d] (a pair of Nines)
Ricapj collected 5284 from main pot
mateuspsb finished the tournament in 278th place
ricefarmer1570 finished the tournament in 279th place
*** SUMMARY ***
Total pot 5988 Main pot 5284. Side pot-1 306. Side pot-2 398. | Rake 0 
Board [Qd 4c Kd 5h 7d]
Seat 1: Ricapj (small blind) showed [6d 2d] and won (5590) with a flush, King high
Seat 2: mateuspsb (big blind) showed [Qh Th] and lost with a pair of Queens
Seat 3: king007five folded before Flop (didn't bet)
Seat 4: Targino33 folded before Flop
Seat 5: 2BeSassy folded before Flop (didn't bet)
Seat 6: elmillu folded before Flop (didn't bet)
Seat 7: anita830 folded before Flop
Seat 8: hzane showed [Ac Ad] and won (398) with a pair of Aces
Seat 9: ricefarmer1570 (button) showed [9h 9d] and lost with a pair of Nines



PokerStars Hand #189157337823: Tournament #2361851754, 9000+1000 Hold'em No Limit - Level IX (40/80) - 2018/07/25 20:40:36 ET
Table '2361851754 35' 9-max Seat #1 is the button
Seat 1: Ricapj (5590 in chips) 
Seat 3: king007five (962 in chips) 
Seat 4: Targino33 (2771 in chips) 
Seat 5: 2BeSassy (1792 in chips) 
Seat 6: elmillu (993 in chips) 
Seat 7: anita830 (2437 in chips) 
Seat 8: hzane (7611 in chips) 
Ricapj: posts the ante 8
king007five: posts the ante 8
Targino33: posts the ante 8
2BeSassy: posts the ante 8
elmillu: posts the ante 8
anita830: posts the ante 8
hzane: posts the ante 8
king007five: posts small blind 40
Targino33: posts big blind 80
*** HOLE CARDS ***
Dealt to hzane [Kd 4d]
2BeSassy: calls 80
elmillu: folds 
anita830: calls 80
hzane: calls 80
Ricapj: calls 80
king007five: folds 
Targino33: checks 
*** FLOP *** [Qc 8h 7d]
Targino33: checks 
2BeSassy: bets 80
anita830: calls 80
hzane: folds 
Ricapj: calls 80
Targino33: calls 80
*** TURN *** [Qc 8h 7d] [Ts]
Targino33: checks 
2BeSassy: bets 80
anita830: calls 80
Ricapj: raises 160 to 240
Targino33: calls 240
2BeSassy: calls 160
anita830: calls 160
*** RIVER *** [Qc 8h 7d Ts] [As]
Targino33: checks 
2BeSassy: checks 
anita830: bets 80
Ricapj: raises 800 to 880
Targino33: folds 
2BeSassy: folds 
anita830: calls 800
*** SHOW DOWN ***
Ricapj: shows [6c 9h] (a straight, Six to Ten)
anita830: mucks hand 
Ricapj collected 3536 from pot
*** SUMMARY ***
Total pot 3536 | Rake 0 
Board [Qc 8h 7d Ts As]
Seat 1: Ricapj (button) showed [6c 9h] and won (3536) with a straight, Six to Ten
Seat 3: king007five (small blind) folded before Flop
Seat 4: Targino33 (big blind) folded on the River
Seat 5: 2BeSassy folded on the River
Seat 6: elmillu folded before Flop (didn't bet)
Seat 7: anita830 mucked [Ad Js]
Seat 8: hzane folded on the Flop



PokerStars Hand #189157378251: Tournament #2361851754, 9000+1000 Hold'em No Limit - Level X (50/100) - 2018/07/25 20:42:19 ET
Table '2361851754 35' 9-max Seat #3 is the button
Seat 1: Ricapj (7838 in chips) 
Seat 2: 12345nem (1790 in chips) 
Seat 3: king007five (914 in chips) 
Seat 4: Targino33 (2363 in chips) 
Seat 5: 2BeSassy (1384 in chips) 
Seat 6: elmillu (985 in chips) 
Seat 7: anita830 (1149 in chips) 
Seat 8: hzane (7523 in chips) 
Seat 9: jandru69 (860 in chips) 
Ricapj: posts the ante 10
12345nem: posts the ante 10
king007five: posts the ante 10
Targino33: posts the ante 10
2BeSassy: posts the ante 10
elmillu: posts the ante 10
anita830: posts the ante 10
hzane: posts the ante 10
jandru69: posts the ante 10
Targino33: posts small blind 50
2BeSassy: posts big blind 100
*** HOLE CARDS ***
Dealt to hzane [9d 6d]
elmillu: calls 100
anita830: folds 
hzane: calls 100
jandru69: folds 
Ricapj: raises 7728 to 7828 and is all-in
12345nem: calls 1780 and is all-in
king007five: folds 
Targino33: folds 
2BeSassy: folds 
elmillu: folds 
hzane: folds 
Uncalled bet (6048) returned to Ricapj
*** FLOP *** [Ts 8c Ac]
*** TURN *** [Ts 8c Ac] [7d]
*** RIVER *** [Ts 8c Ac 7d] [5d]
*** SHOW DOWN ***
Ricapj: shows [Jd Ah] (a pair of Aces)
12345nem: shows [As Ks] (a pair of Aces - King kicker)
12345nem collected 4000 from pot
*** SUMMARY ***
Total pot 4000 | Rake 0 
Board [Ts 8c Ac 7d 5d]
Seat 1: Ricapj showed [Jd Ah] and lost with a pair of Aces
Seat 2: 12345nem showed [As Ks] and won (4000) with a pair of Aces
Seat 3: king007five (button) folded before Flop (didn't bet)
Seat 4: Targino33 (small blind) folded before Flop
Seat 5: 2BeSassy (big blind) folded before Flop
Seat 6: elmillu folded before Flop
Seat 7: anita830 folded before Flop (didn't bet)
Seat 8: hzane folded before Flop
Seat 9: jandru69 folded before Flop (didn't bet)



PokerStars Hand #189157394212: Tournament #2361851754, 9000+1000 Hold'em No Limit - Level X (50/100) - 2018/07/25 20:42:59 ET
Table '2361851754 35' 9-max Seat #4 is the button
Seat 1: Ricapj (6048 in chips) 
Seat 2: 12345nem (4000 in chips) 
Seat 3: king007five (904 in chips) 
Seat 4: Targino33 (2303 in chips) 
Seat 5: 2BeSassy (1274 in chips) 
Seat 6: elmillu (875 in chips) 
Seat 7: anita830 (1139 in chips) 
Seat 8: hzane (7413 in chips) 
Seat 9: jandru69 (850 in chips) 
Ricapj: posts the ante 10
12345nem: posts the ante 10
king007five: posts the ante 10
Targino33: posts the ante 10
2BeSassy: posts the ante 10
elmillu: posts the ante 10
anita830: posts the ante 10
hzane: posts the ante 10
jandru69: posts the ante 10
2BeSassy: posts small blind 50
elmillu: posts big blind 100
*** HOLE CARDS ***
Dealt to hzane [7h Jc]
anita830: folds 
hzane: folds 
jandru69: folds 
Ricapj: calls 100
12345nem: folds 
king007five: folds 
Targino33: calls 100
2BeSassy: calls 50
elmillu: checks 
*** FLOP *** [Kh 8c 6s]
2BeSassy: checks 
elmillu: bets 100
Ricapj: folds 
Targino33: calls 100
2BeSassy: folds 
*** TURN *** [Kh 8c 6s] [4c]
elmillu: bets 100
Targino33: calls 100
*** RIVER *** [Kh 8c 6s 4c] [Ac]
elmillu: checks 
Targino33: bets 300
elmillu: calls 300
*** SHOW DOWN ***
Targino33: shows [8d 2c] (a pair of Eights)
elmillu: shows [Qh Kd] (a pair of Kings)
elmillu collected 1490 from pot
*** SUMMARY ***
Total pot 1490 | Rake 0 
Board [Kh 8c 6s 4c Ac]
Seat 1: Ricapj folded on the Flop
Seat 2: 12345nem folded before Flop (didn't bet)
Seat 3: king007five folded before Flop (didn't bet)
Seat 4: Targino33 (button) showed [8d 2c] and lost with a pair of Eights
Seat 5: 2BeSassy (small blind) folded on the Flop
Seat 6: elmillu (big blind) showed [Qh Kd] and won (1490) with a pair of Kings
Seat 7: anita830 folded before Flop (didn't bet)
Seat 8: hzane folded before Flop (didn't bet)
Seat 9: jandru69 folded before Flop (didn't bet)



PokerStars Hand #189157426911: Tournament #2361851754, 9000+1000 Hold'em No Limit - Level X (50/100) - 2018/07/25 20:44:24 ET
Table '2361851754 35' 9-max Seat #5 is the button
Seat 1: Ricapj (5938 in chips) 
Seat 2: 12345nem (3990 in chips) 
Seat 3: king007five (894 in chips) 
Seat 4: Targino33 (1693 in chips) 
Seat 5: 2BeSassy (1164 in chips) 
Seat 6: elmillu (1755 in chips) 
Seat 7: anita830 (1129 in chips) 
Seat 8: hzane (7403 in chips) 
Seat 9: jandru69 (840 in chips) 
Ricapj: posts the ante 10
12345nem: posts the ante 10
king007five: posts the ante 10
Targino33: posts the ante 10
2BeSassy: posts the ante 10
elmillu: posts the ante 10
anita830: posts the ante 10
hzane: posts the ante 10
jandru69: posts the ante 10
elmillu: posts small blind 50
anita830: posts big blind 100
*** HOLE CARDS ***
Dealt to hzane [Tc 9h]
hzane: calls 100
jandru69: folds 
Ricapj: folds 
12345nem: calls 100
king007five: folds 
Targino33: calls 100
2BeSassy: folds 
elmillu: calls 50
anita830: checks 
*** FLOP *** [Qh Kc 8c]
elmillu has timed out
elmillu: checks 
anita830: checks 
hzane: bets 300
12345nem: folds 
Targino33: calls 300
elmillu: calls 300
anita830: calls 300
*** TURN *** [Qh Kc 8c] [3c]
elmillu: checks 
anita830: bets 719 and is all-in
hzane: calls 719
Targino33: calls 719
elmillu: calls 719
*** RIVER *** [Qh Kc 8c 3c] [7d]
elmillu: checks 
hzane: checks 
Targino33: bets 564 and is all-in
elmillu: folds 
hzane: folds 
Uncalled bet (564) returned to Targino33
*** SHOW DOWN ***
Targino33: shows [Kh 9c] (a pair of Kings)
anita830: shows [7c 4c] (a flush, King high)
anita830 collected 4666 from pot
*** SUMMARY ***
Total pot 4666 | Rake 0 
Board [Qh Kc 8c 3c 7d]
Seat 1: Ricapj folded before Flop (didn't bet)
Seat 2: 12345nem folded on the Flop
Seat 3: king007five folded before Flop (didn't bet)
Seat 4: Targino33 showed [Kh 9c] and lost with a pair of Kings
Seat 5: 2BeSassy (button) folded before Flop (didn't bet)
Seat 6: elmillu (small blind) folded on the River
Seat 7: anita830 (big blind) showed [7c 4c] and won (4666) with a flush, King high
Seat 8: hzane folded on the River
Seat 9: jandru69 folded before Flop (didn't bet)



PokerStars Hand #189157486582: Tournament #2361851754, 9000+1000 Hold'em No Limit - Level XI (60/120) - 2018/07/25 20:46:58 ET
Table '2361851754 35' 9-max Seat #6 is the button
Seat 1: Ricapj (5928 in chips) 
Seat 2: 12345nem (3880 in chips) 
Seat 4: Targino33 (564 in chips) 
Seat 5: 2BeSassy (1154 in chips) 
Seat 6: elmillu (626 in chips) 
Seat 7: anita830 (4666 in chips) 
Seat 8: hzane (6274 in chips) 
Seat 9: jandru69 (830 in chips) 
Ricapj: posts the ante 12
12345nem: posts the ante 12
Targino33: posts the ante 12
2BeSassy: posts the ante 12
elmillu: posts the ante 12
anita830: posts the ante 12
hzane: posts the ante 12
jandru69: posts the ante 12
anita830: posts small blind 60
hzane: posts big blind 120
*** HOLE CARDS ***
Dealt to hzane [6s Ad]
jandru69: folds 
Ricapj: folds 
12345nem has timed out
12345nem: folds 
Targino33: raises 432 to 552 and is all-in
2BeSassy: folds 
elmillu: folds 
anita830: calls 492
hzane: folds 
*** FLOP *** [Kc 2s Jd]
*** TURN *** [Kc 2s Jd] [Ac]
*** RIVER *** [Kc 2s Jd Ac] [5d]
*** SHOW DOWN ***
anita830: shows [Qd 3d] (high card Ace)
Targino33: shows [Ah Jh] (two pair, Aces and Jacks)
Targino33 collected 1320 from pot
*** SUMMARY ***
Total pot 1320 | Rake 0 
Board [Kc 2s Jd Ac 5d]
Seat 1: Ricapj folded before Flop (didn't bet)
Seat 2: 12345nem folded before Flop (didn't bet)
Seat 4: Targino33 showed [Ah Jh] and won (1320) with two pair, Aces and Jacks
Seat 5: 2BeSassy folded before Flop (didn't bet)
Seat 6: elmillu (button) folded before Flop (didn't bet)
Seat 7: anita830 (small blind) showed [Qd 3d] and lost with high card Ace
Seat 8: hzane (big blind) folded before Flop
Seat 9: jandru69 folded before Flop (didn't bet)



PokerStars Hand #189157508750: Tournament #2361851754, 9000+1000 Hold'em No Limit - Level XI (60/120) - 2018/07/25 20:47:55 ET
Table '2361851754 35' 9-max Seat #7 is the button
Seat 1: Ricapj (5916 in chips) 
Seat 2: 12345nem (3868 in chips) 
Seat 3: booris23 (228 in chips) 
Seat 4: Targino33 (1320 in chips) 
Seat 5: 2BeSassy (1142 in chips) 
Seat 6: elmillu (614 in chips) 
Seat 7: anita830 (4102 in chips) 
Seat 8: hzane (6142 in chips) 
Seat 9: jandru69 (818 in chips) 
Ricapj: posts the ante 12
12345nem: posts the ante 12
booris23: posts the ante 12
Targino33: posts the ante 12
2BeSassy: posts the ante 12
elmillu: posts the ante 12
anita830: posts the ante 12
hzane: posts the ante 12
jandru69: posts the ante 12
hzane: posts small blind 60
jandru69: posts big blind 120
*** HOLE CARDS ***
Dealt to hzane [7h 6c]
Ricapj: folds 
12345nem: calls 120
booris23: folds 
Targino33: calls 120
2BeSassy: folds 
elmillu: calls 120
anita830: folds 
hzane: folds 
jandru69: checks 
*** FLOP *** [Jc 7d Ah]
jandru69: checks 
12345nem: checks 
Targino33: bets 240
elmillu: raises 242 to 482 and is all-in
jandru69: folds 
12345nem: folds 
Targino33: calls 242
*** TURN *** [Jc 7d Ah] [Ac]
*** RIVER *** [Jc 7d Ah Ac] [5d]
*** SHOW DOWN ***
Targino33: shows [Kc Qh] (a pair of Aces)
elmillu: shows [Ad 4s] (three of a kind, Aces)
elmillu collected 1612 from pot
*** SUMMARY ***
Total pot 1612 | Rake 0 
Board [Jc 7d Ah Ac 5d]
Seat 1: Ricapj folded before Flop (didn't bet)
Seat 2: 12345nem folded on the Flop
Seat 3: booris23 folded before Flop (didn't bet)
Seat 4: Targino33 showed [Kc Qh] and lost with a pair of Aces
Seat 5: 2BeSassy folded before Flop (didn't bet)
Seat 6: elmillu showed [Ad 4s] and won (1612) with three of a kind, Aces
Seat 7: anita830 (button) folded before Flop (didn't bet)
Seat 8: hzane (small blind) folded before Flop
Seat 9: jandru69 (big blind) folded on the Flop



PokerStars Hand #189157526882: Tournament #2361851754, 9000+1000 Hold'em No Limit - Level XII (70/140) - 2018/07/25 20:48:43 ET
Table '2361851754 35' 9-max Seat #8 is the button
Seat 1: Ricapj (5904 in chips) 
Seat 2: 12345nem (3736 in chips) 
Seat 3: booris23 (216 in chips) 
Seat 4: Targino33 (706 in chips) 
Seat 5: 2BeSassy (1130 in chips) 
Seat 6: elmillu (1612 in chips) 
Seat 7: anita830 (4090 in chips) 
Seat 8: hzane (6070 in chips) 
Seat 9: jandru69 (686 in chips) 
Ricapj: posts the ante 14
12345nem: posts the ante 14
booris23: posts the ante 14
Targino33: posts the ante 14
2BeSassy: posts the ante 14
elmillu: posts the ante 14
anita830: posts the ante 14
hzane: posts the ante 14
jandru69: posts the ante 14
jandru69: posts small blind 70
Ricapj: posts big blind 140
*** HOLE CARDS ***
Dealt to hzane [Td Ad]
12345nem: calls 140
booris23: folds 
Targino33: folds 
2BeSassy: calls 140
elmillu: calls 140
anita830: folds 
hzane: raises 140 to 280
jandru69: folds 
Ricapj: folds 
12345nem: calls 140
2BeSassy: calls 140
elmillu: calls 140
*** FLOP *** [Kh Kc Ks]
12345nem: checks 
2BeSassy: checks 
elmillu: checks 
hzane: bets 140
12345nem: raises 140 to 280
2BeSassy: calls 280
elmillu: folds 
hzane: raises 420 to 700
12345nem: folds 
2BeSassy: folds 
Uncalled bet (420) returned to hzane
hzane collected 2296 from pot
*** SUMMARY ***
Total pot 2296 | Rake 0 
Board [Kh Kc Ks]
Seat 1: Ricapj (big blind) folded before Flop
Seat 2: 12345nem folded on the Flop
Seat 3: booris23 folded before Flop (didn't bet)
Seat 4: Targino33 folded before Flop (didn't bet)
Seat 5: 2BeSassy folded on the Flop
Seat 6: elmillu folded on the Flop
Seat 7: anita830 folded before Flop (didn't bet)
Seat 8: hzane (button) collected (2296)
Seat 9: jandru69 (small blind) folded before Flop



PokerStars Hand #189157553401: Tournament #2361851754, 9000+1000 Hold'em No Limit - Level XII (70/140) - 2018/07/25 20:49:53 ET
Table '2361851754 35' 9-max Seat #9 is the button
Seat 1: Ricapj (5750 in chips) 
Seat 2: 12345nem (3162 in chips) 
Seat 3: booris23 (202 in chips) 
Seat 4: Targino33 (692 in chips) 
Seat 5: 2BeSassy (556 in chips) 
Seat 6: elmillu (1318 in chips) 
Seat 7: anita830 (4076 in chips) 
Seat 8: hzane (7792 in chips) 
Seat 9: jandru69 (602 in chips) 
Ricapj: posts the ante 14
12345nem: posts the ante 14
booris23: posts the ante 14
Targino33: posts the ante 14
2BeSassy: posts the ante 14
elmillu: posts the ante 14
anita830: posts the ante 14
hzane: posts the ante 14
jandru69: posts the ante 14
Ricapj: posts small blind 70
12345nem: posts big blind 140
*** HOLE CARDS ***
Dealt to hzane [7d 4c]
booris23: folds 
Targino33: folds 
2BeSassy: folds 
elmillu: folds 
anita830: calls 140
hzane: folds 
jandru69: folds 
Ricapj: raises 140 to 280
12345nem: calls 140
anita830: calls 140
*** FLOP *** [Ah 6h Tc]
Ricapj: bets 140
12345nem: folds 
anita830: calls 140
*** TURN *** [Ah 6h Tc] [Ks]
Ricapj: bets 140
anita830: calls 140
*** RIVER *** [Ah 6h Tc Ks] [6c]
Ricapj: bets 1540
anita830: folds 
Uncalled bet (1540) returned to Ricapj
Ricapj collected 1526 from pot
*** SUMMARY ***
Total pot 1526 | Rake 0 
Board [Ah 6h Tc Ks 6c]
Seat 1: Ricapj (small blind) collected (1526)
Seat 2: 12345nem (big blind) folded on the Flop
Seat 3: booris23 folded before Flop (didn't bet)
Seat 4: Targino33 folded before Flop (didn't bet)
Seat 5: 2BeSassy folded before Flop (didn't bet)
Seat 6: elmillu folded before Flop (didn't bet)
Seat 7: anita830 folded on the River
Seat 8: hzane folded before Flop (didn't bet)
Seat 9: jandru69 (button) folded before Flop (didn't bet)



PokerStars Hand #189157572473: Tournament #2361851754, 9000+1000 Hold'em No Limit - Level XII (70/140) - 2018/07/25 20:50:44 ET
Table '2361851754 35' 9-max Seat #1 is the button
Seat 1: Ricapj (6702 in chips) 
Seat 2: 12345nem (2868 in chips) 
Seat 3: booris23 (188 in chips) 
Seat 4: Targino33 (678 in chips) 
Seat 5: 2BeSassy (542 in chips) 
Seat 6: elmillu (1304 in chips) 
Seat 7: anita830 (3502 in chips) 
Seat 8: hzane (7778 in chips) 
Seat 9: jandru69 (588 in chips) 
Ricapj: posts the ante 14
12345nem: posts the ante 14
booris23: posts the ante 14
Targino33: posts the ante 14
2BeSassy: posts the ante 14
elmillu: posts the ante 14
anita830: posts the ante 14
hzane: posts the ante 14
jandru69: posts the ante 14
12345nem: posts small blind 70
booris23: posts big blind 140
*** HOLE CARDS ***
Dealt to hzane [2h Jh]
Targino33: calls 140
2BeSassy: folds 
elmillu: folds 
anita830: calls 140
hzane: calls 140
jandru69: folds 
Ricapj: raises 1260 to 1400
12345nem: calls 1330
booris23: calls 34 and is all-in
Targino33: calls 524 and is all-in
anita830: calls 1260
hzane: folds 
*** FLOP *** [8h Qc 9c]
12345nem: checks 
anita830: checks 
Ricapj: bets 2240
12345nem: folds 
anita830: calls 2088 and is all-in
Uncalled bet (152) returned to Ricapj
*** TURN *** [8h Qc 9c] [2d]
*** RIVER *** [8h Qc 9c 2d] [Kh]
*** SHOW DOWN ***
anita830: shows [Kc 7h] (a pair of Kings)
Ricapj: shows [9s Ts] (a pair of Nines)
anita830 collected 6384 from side pot-2 
Targino33: shows [Jc Ah] (high card Ace)
anita830 collected 1960 from side pot-1 
booris23: shows [Th Ks] (a pair of Kings - Queen+Ten kicker)
booris23 collected 1136 from main pot
Targino33 finished the tournament in 195th place
*** SUMMARY ***
Total pot 9480 Main pot 1136. Side pot-1 1960. Side pot-2 6384. | Rake 0 
Board [8h Qc 9c 2d Kh]
Seat 1: Ricapj (button) showed [9s Ts] and lost with a pair of Nines
Seat 2: 12345nem (small blind) folded on the Flop
Seat 3: booris23 (big blind) showed [Th Ks] and won (1136) with a pair of Kings
Seat 4: Targino33 showed [Jc Ah] and lost with high card Ace
Seat 5: 2BeSassy folded before Flop (didn't bet)
Seat 6: elmillu folded before Flop (didn't bet)
Seat 7: anita830 showed [Kc 7h] and won (8344) with a pair of Kings
Seat 8: hzane folded before Flop
Seat 9: jandru69 folded before Flop (didn't bet)



PokerStars Hand #189157596120: Tournament #2361851754, 9000+1000 Hold'em No Limit - Level XIII (80/160) - 2018/07/25 20:51:48 ET
Table '2361851754 35' 9-max Seat #2 is the button
Seat 1: Ricapj (3200 in chips) 
Seat 2: 12345nem (1454 in chips) 
Seat 3: booris23 (1136 in chips) 
Seat 5: 2BeSassy (528 in chips) 
Seat 6: elmillu (1290 in chips) 
Seat 7: anita830 (8344 in chips) 
Seat 8: hzane (7624 in chips) 
Seat 9: jandru69 (574 in chips) 
Ricapj: posts the ante 16
12345nem: posts the ante 16
booris23: posts the ante 16
2BeSassy: posts the ante 16
elmillu: posts the ante 16
anita830: posts the ante 16
hzane: posts the ante 16
jandru69: posts the ante 16
booris23: posts small blind 80
2BeSassy: posts big blind 160
*** HOLE CARDS ***
Dealt to hzane [6s 2d]
elmillu: folds 
anita830: folds 
hzane: folds 
jandru69: folds 
Ricapj: calls 160
12345nem: calls 160
booris23: calls 80
2BeSassy: checks 
*** FLOP *** [Ah 3c 4d]
booris23: checks 
2BeSassy: bets 160
Ricapj: raises 1120 to 1280
12345nem: folds 
booris23: folds 
2BeSassy: calls 192 and is all-in
Uncalled bet (928) returned to Ricapj
*** TURN *** [Ah 3c 4d] [Ac]
*** RIVER *** [Ah 3c 4d Ac] [Jc]
*** SHOW DOWN ***
2BeSassy: shows [Qs As] (three of a kind, Aces)
Ricapj: shows [8s 5d] (a pair of Aces)
2BeSassy collected 1472 from pot
*** SUMMARY ***
Total pot 1472 | Rake 0 
Board [Ah 3c 4d Ac Jc]
Seat 1: Ricapj showed [8s 5d] and lost with a pair of Aces
Seat 2: 12345nem (button) folded on the Flop
Seat 3: booris23 (small blind) folded on the Flop
Seat 5: 2BeSassy (big blind) showed [Qs As] and won (1472) with three of a kind, Aces
Seat 6: elmillu folded before Flop (didn't bet)
Seat 7: anita830 folded before Flop (didn't bet)
Seat 8: hzane folded before Flop (didn't bet)
Seat 9: jandru69 folded before Flop (didn't bet)



PokerStars Hand #189157613088: Tournament #2361851754, 9000+1000 Hold'em No Limit - Level XIII (80/160) - 2018/07/25 20:52:34 ET
Table '2361851754 35' 9-max Seat #3 is the button
Seat 1: Ricapj (2672 in chips) 
Seat 2: 12345nem (1278 in chips) 
Seat 3: booris23 (960 in chips) 
Seat 5: 2BeSassy (1472 in chips) 
Seat 6: elmillu (1274 in chips) 
Seat 7: anita830 (8328 in chips) 
Seat 8: hzane (7608 in chips) 
Seat 9: jandru69 (558 in chips) 
Ricapj: posts the ante 16
12345nem: posts the ante 16
booris23: posts the ante 16
2BeSassy: posts the ante 16
elmillu: posts the ante 16
anita830: posts the ante 16
hzane: posts the ante 16
jandru69: posts the ante 16
2BeSassy: posts small blind 80
elmillu: posts big blind 160
*** HOLE CARDS ***
Dealt to hzane [2c 8d]
anita830: raises 1440 to 1600
hzane: folds 
jandru69: folds 
Ricapj: raises 1056 to 2656 and is all-in
12345nem: folds 
booris23: folds 
2BeSassy: folds 
elmillu: folds 
anita830: calls 1056
*** FLOP *** [Ad 3h Js]
*** TURN *** [Ad 3h Js] [Ks]
*** RIVER *** [Ad 3h Js Ks] [Jc]
*** SHOW DOWN ***
anita830: shows [7s 7d] (two pair, Jacks and Sevens)
Ricapj: shows [6s 4d] (a pair of Jacks)
anita830 collected 5680 from pot
Ricapj finished the tournament in 185th place
*** SUMMARY ***
Total pot 5680 | Rake 0 
Board [Ad 3h Js Ks Jc]
Seat 1: Ricapj showed [6s 4d] and lost with a pair of Jacks
Seat 2: 12345nem folded before Flop (didn't bet)
Seat 3: booris23 (button) folded before Flop (didn't bet)
Seat 5: 2BeSassy (small blind) folded before Flop
Seat 6: elmillu (big blind) folded before Flop
Seat 7: anita830 showed [7s 7d] and won (5680) with two pair, Jacks and Sevens
Seat 8: hzane folded before Flop (didn't bet)
Seat 9: jandru69 folded before Flop (didn't bet)



PokerStars Hand #189157624796: Tournament #2361851754, 9000+1000 Hold'em No Limit - Level XIII (80/160) - 2018/07/25 20:53:05 ET
Table '2361851754 35' 9-max Seat #5 is the button
Seat 2: 12345nem (1262 in chips) 
Seat 3: booris23 (944 in chips) 
Seat 4: snowfox568 (6530 in chips) 
Seat 5: 2BeSassy (1376 in chips) 
Seat 6: elmillu (1098 in chips) 
Seat 7: anita830 (11336 in chips) 
Seat 8: hzane (7592 in chips) 
Seat 9: jandru69 (542 in chips) 
12345nem: posts the ante 16
booris23: posts the ante 16
snowfox568: posts the ante 16
2BeSassy: posts the ante 16
elmillu: posts the ante 16
anita830: posts the ante 16
hzane: posts the ante 16
jandru69: posts the ante 16
elmillu: posts small blind 80
anita830: posts big blind 160
*** HOLE CARDS ***
Dealt to hzane [Tc Kh]
hzane: calls 160
jandru69: folds 
12345nem: folds 
booris23: calls 160
snowfox568: calls 160
2BeSassy: folds 
elmillu: folds 
anita830: checks 
*** FLOP *** [5h 8d As]
anita830: checks 
hzane: checks 
booris23: checks 
snowfox568: checks 
*** TURN *** [5h 8d As] [Jd]
anita830: checks 
hzane: bets 160
booris23: folds 
snowfox568: calls 160
anita830: calls 160
*** RIVER *** [5h 8d As Jd] [9d]
anita830: checks 
hzane: checks 
snowfox568: bets 320
anita830: folds 
hzane: folds 
Uncalled bet (320) returned to snowfox568
snowfox568 collected 1328 from pot
snowfox568: doesn't show hand 
*** SUMMARY ***
Total pot 1328 | Rake 0 
Board [5h 8d As Jd 9d]
Seat 2: 12345nem folded before Flop (didn't bet)
Seat 3: booris23 folded on the Turn
Seat 4: snowfox568 collected (1328)
Seat 5: 2BeSassy (button) folded before Flop (didn't bet)
Seat 6: elmillu (small blind) folded before Flop
Seat 7: anita830 (big blind) folded on the River
Seat 8: hzane folded on the River
Seat 9: jandru69 folded before Flop (didn't bet)



PokerStars Hand #189157659102: Tournament #2361851754, 9000+1000 Hold'em No Limit - Level XIV (100/200) - 2018/07/25 20:54:37 ET
Table '2361851754 35' 9-max Seat #6 is the button
Seat 1: d0re (3098 in chips) 
Seat 2: 12345nem (1246 in chips) 
Seat 3: booris23 (768 in chips) 
Seat 4: snowfox568 (7522 in chips) 
Seat 5: 2BeSassy (1360 in chips) 
Seat 6: elmillu (1002 in chips) is sitting out
Seat 7: anita830 (11000 in chips) 
Seat 8: hzane (7256 in chips) 
Seat 9: jandru69 (526 in chips) 
d0re: posts the ante 20
12345nem: posts the ante 20
booris23: posts the ante 20
snowfox568: posts the ante 20
2BeSassy: posts the ante 20
elmillu: posts the ante 20
anita830: posts the ante 20
hzane: posts the ante 20
jandru69: posts the ante 20
anita830: posts small blind 100
hzane: posts big blind 200
*** HOLE CARDS ***
Dealt to hzane [3s Jc]
jandru69: calls 200
d0re: calls 200
12345nem: calls 200
booris23: calls 200
snowfox568: folds 
2BeSassy: folds 
elmillu: folds 
anita830: calls 100
hzane: checks 
*** FLOP *** [Ts Qh Jh]
anita830: checks 
hzane: bets 200
jandru69: raises 106 to 306 and is all-in
d0re: raises 2572 to 2878 and is all-in
12345nem: calls 1026 and is all-in
booris23: folds 
anita830: folds 
hzane: folds 
Uncalled bet (1852) returned to d0re
*** TURN *** [Ts Qh Jh] [2d]
*** RIVER *** [Ts Qh Jh 2d] [Ac]
*** SHOW DOWN ***
d0re: shows [9s As] (a pair of Aces)
12345nem: shows [Ks 6c] (a straight, Ten to Ace)
12345nem collected 1440 from side pot
jandru69: shows [Jd 5d] (a pair of Jacks)
12345nem collected 2498 from main pot
jandru69 finished the tournament in 172nd place
*** SUMMARY ***
Total pot 3938 Main pot 2498. Side pot 1440. | Rake 0 
Board [Ts Qh Jh 2d Ac]
Seat 1: d0re showed [9s As] and lost with a pair of Aces
Seat 2: 12345nem showed [Ks 6c] and won (3938) with a straight, Ten to Ace
Seat 3: booris23 folded on the Flop
Seat 4: snowfox568 folded before Flop (didn't bet)
Seat 5: 2BeSassy folded before Flop (didn't bet)
Seat 6: elmillu (button) folded before Flop (didn't bet)
Seat 7: anita830 (small blind) folded on the Flop
Seat 8: hzane (big blind) folded on the Flop
Seat 9: jandru69 showed [Jd 5d] and lost with a pair of Jacks



PokerStars Hand #189157807618: Tournament #2361851754, 9000+1000 Hold'em No Limit - Level XIV (100/200) - 2018/07/25 21:02:17 ET
Table '2361851754 3' 9-max Seat #4 is the button
Seat 1: Gorilla JB (1556 in chips) 
Seat 2: endler76 (8663 in chips) 
Seat 3: hzane (6836 in chips) 
Seat 4: Nikola197022 (3821 in chips) 
Seat 5: SYC55 (5417 in chips) 
Seat 6: Weretawe (10570 in chips) is sitting out
Seat 7: slickrick358 (2822 in chips) 
Seat 8: hachinaglia (1002 in chips) is sitting out
Seat 9: tpdg64 (4114 in chips) 
Gorilla JB: posts the ante 20
endler76: posts the ante 20
hzane: posts the ante 20
Nikola197022: posts the ante 20
SYC55: posts the ante 20
Weretawe: posts the ante 20
slickrick358: posts the ante 20
hachinaglia: posts the ante 20
tpdg64: posts the ante 20
SYC55: posts small blind 100
Weretawe: posts big blind 200
*** HOLE CARDS ***
Dealt to hzane [4s 4c]
slickrick358: calls 200
hachinaglia: folds 
tpdg64: folds 
Gorilla JB: folds 
endler76: folds 
hzane: calls 200
Nikola197022: folds 
SYC55: folds 
Weretawe: checks 
*** FLOP *** [2d Kd Ks]
Weretawe: checks 
slickrick358: checks 
hzane: bets 440
Weretawe: folds 
slickrick358: folds 
Uncalled bet (440) returned to hzane
hzane collected 880 from pot
*** SUMMARY ***
Total pot 880 | Rake 0 
Board [2d Kd Ks]
Seat 1: Gorilla JB folded before Flop (didn't bet)
Seat 2: endler76 folded before Flop (didn't bet)
Seat 3: hzane collected (880)
Seat 4: Nikola197022 (button) folded before Flop (didn't bet)
Seat 5: SYC55 (small blind) folded before Flop
Seat 6: Weretawe (big blind) folded on the Flop
Seat 7: slickrick358 folded on the Flop
Seat 8: hachinaglia folded before Flop (didn't bet)
Seat 9: tpdg64 folded before Flop (didn't bet)



PokerStars Hand #189157824901: Tournament #2361851754, 9000+1000 Hold'em No Limit - Level XIV (100/200) - 2018/07/25 21:03:05 ET
Table '2361851754 3' 9-max Seat #5 is the button
Seat 1: Gorilla JB (1536 in chips) 
Seat 2: endler76 (8643 in chips) 
Seat 3: hzane (7496 in chips) 
Seat 4: Nikola197022 (3801 in chips) 
Seat 5: SYC55 (5297 in chips) 
Seat 6: Weretawe (10350 in chips) 
Seat 7: slickrick358 (2602 in chips) 
Seat 8: hachinaglia (982 in chips) is sitting out
Seat 9: tpdg64 (4094 in chips) 
Gorilla JB: posts the ante 20
endler76: posts the ante 20
hzane: posts the ante 20
Nikola197022: posts the ante 20
SYC55: posts the ante 20
Weretawe: posts the ante 20
slickrick358: posts the ante 20
hachinaglia: posts the ante 20
tpdg64: posts the ante 20
Weretawe: posts small blind 100
slickrick358: posts big blind 200
*** HOLE CARDS ***
Dealt to hzane [5h Qc]
hachinaglia: folds 
tpdg64: calls 200
Gorilla JB: folds 
endler76: folds 
hzane: folds 
Nikola197022: folds 
SYC55: folds 
Weretawe: calls 100
slickrick358: checks 
*** FLOP *** [4d 6d 7s]
Weretawe: bets 600
slickrick358: folds 
tpdg64: folds 
Uncalled bet (600) returned to Weretawe
Weretawe collected 780 from pot
Weretawe: doesn't show hand 
*** SUMMARY ***
Total pot 780 | Rake 0 
Board [4d 6d 7s]
Seat 1: Gorilla JB folded before Flop (didn't bet)
Seat 2: endler76 folded before Flop (didn't bet)
Seat 3: hzane folded before Flop (didn't bet)
Seat 4: Nikola197022 folded before Flop (didn't bet)
Seat 5: SYC55 (button) folded before Flop (didn't bet)
Seat 6: Weretawe (small blind) collected (780)
Seat 7: slickrick358 (big blind) folded on the Flop
Seat 8: hachinaglia folded before Flop (didn't bet)
Seat 9: tpdg64 folded on the Flop



PokerStars Hand #189157840662: Tournament #2361851754, 9000+1000 Hold'em No Limit - Level XV (120/240) - 2018/07/25 21:03:48 ET
Table '2361851754 3' 9-max Seat #6 is the button
Seat 1: Gorilla JB (1516 in chips) 
Seat 2: endler76 (8623 in chips) 
Seat 3: hzane (7476 in chips) 
Seat 4: Nikola197022 (3781 in chips) 
Seat 5: SYC55 (5277 in chips) 
Seat 6: Weretawe (10910 in chips) 
Seat 7: slickrick358 (2382 in chips) 
Seat 8: hachinaglia (962 in chips) is sitting out
Seat 9: tpdg64 (3874 in chips) 
Gorilla JB: posts the ante 24
endler76: posts the ante 24
hzane: posts the ante 24
Nikola197022: posts the ante 24
SYC55: posts the ante 24
Weretawe: posts the ante 24
slickrick358: posts the ante 24
hachinaglia: posts the ante 24
tpdg64: posts the ante 24
slickrick358: posts small blind 120
hachinaglia: posts big blind 240
*** HOLE CARDS ***
Dealt to hzane [Td 8c]
tpdg64: folds 
Gorilla JB: folds 
endler76: folds 
hzane: folds 
Nikola197022: folds 
SYC55: raises 480 to 720
Weretawe: folds 
slickrick358: folds 
hachinaglia: folds 
Uncalled bet (480) returned to SYC55
SYC55 collected 816 from pot
SYC55: doesn't show hand 
*** SUMMARY ***
Total pot 816 | Rake 0 
Seat 1: Gorilla JB folded before Flop (didn't bet)
Seat 2: endler76 folded before Flop (didn't bet)
Seat 3: hzane folded before Flop (didn't bet)
Seat 4: Nikola197022 folded before Flop (didn't bet)
Seat 5: SYC55 collected (816)
Seat 6: Weretawe (button) folded before Flop (didn't bet)
Seat 7: slickrick358 (small blind) folded before Flop
Seat 8: hachinaglia (big blind) folded before Flop
Seat 9: tpdg64 folded before Flop (didn't bet)



PokerStars Hand #189157850413: Tournament #2361851754, 9000+1000 Hold'em No Limit - Level XV (120/240) - 2018/07/25 21:04:15 ET
Table '2361851754 3' 9-max Seat #7 is the button
Seat 1: Gorilla JB (1492 in chips) 
Seat 2: endler76 (8599 in chips) 
Seat 3: hzane (7452 in chips) 
Seat 4: Nikola197022 (3757 in chips) 
Seat 5: SYC55 (5829 in chips) 
Seat 6: Weretawe (10886 in chips) 
Seat 7: slickrick358 (2238 in chips) 
Seat 8: hachinaglia (698 in chips) is sitting out
Seat 9: tpdg64 (3850 in chips) 
Gorilla JB: posts the ante 24
endler76: posts the ante 24
hzane: posts the ante 24
Nikola197022: posts the ante 24
SYC55: posts the ante 24
Weretawe: posts the ante 24
slickrick358: posts the ante 24
hachinaglia: posts the ante 24
tpdg64: posts the ante 24
hachinaglia: posts small blind 120
tpdg64: posts big blind 240
*** HOLE CARDS ***
Dealt to hzane [2d 3c]
Gorilla JB: folds 
endler76: raises 240 to 480
hzane: folds 
Nikola197022 has timed out
Nikola197022: folds 
SYC55: folds 
Weretawe: folds 
slickrick358: folds 
hachinaglia: folds 
tpdg64: folds 
Uncalled bet (240) returned to endler76
endler76 collected 816 from pot
*** SUMMARY ***
Total pot 816 | Rake 0 
Seat 1: Gorilla JB folded before Flop (didn't bet)
Seat 2: endler76 collected (816)
Seat 3: hzane folded before Flop (didn't bet)
Seat 4: Nikola197022 folded before Flop (didn't bet)
Seat 5: SYC55 folded before Flop (didn't bet)
Seat 6: Weretawe folded before Flop (didn't bet)
Seat 7: slickrick358 (button) folded before Flop (didn't bet)
Seat 8: hachinaglia (small blind) folded before Flop
Seat 9: tpdg64 (big blind) folded before Flop



PokerStars Hand #189157865487: Tournament #2361851754, 9000+1000 Hold'em No Limit - Level XV (120/240) - 2018/07/25 21:04:56 ET
Table '2361851754 3' 9-max Seat #8 is the button
Seat 1: Gorilla JB (1468 in chips) 
Seat 2: endler76 (9151 in chips) 
Seat 3: hzane (7428 in chips) 
Seat 4: Nikola197022 (3733 in chips) is sitting out
Seat 5: SYC55 (5805 in chips) 
Seat 6: Weretawe (10862 in chips) 
Seat 7: slickrick358 (2214 in chips) 
Seat 8: hachinaglia (554 in chips) is sitting out
Seat 9: tpdg64 (3586 in chips) 
Gorilla JB: posts the ante 24
endler76: posts the ante 24
hzane: posts the ante 24
Nikola197022: posts the ante 24
SYC55: posts the ante 24
Weretawe: posts the ante 24
slickrick358: posts the ante 24
hachinaglia: posts the ante 24
tpdg64: posts the ante 24
tpdg64: posts small blind 120
Gorilla JB: posts big blind 240
*** HOLE CARDS ***
Dealt to hzane [8s 3s]
endler76: raises 720 to 960
hzane: folds 
Nikola197022: folds 
SYC55: folds 
Weretawe: folds 
slickrick358: folds 
hachinaglia: folds 
tpdg64: folds 
Gorilla JB: folds 
Uncalled bet (720) returned to endler76
endler76 collected 816 from pot
*** SUMMARY ***
Total pot 816 | Rake 0 
Seat 1: Gorilla JB (big blind) folded before Flop
Seat 2: endler76 collected (816)
Seat 3: hzane folded before Flop (didn't bet)
Seat 4: Nikola197022 folded before Flop (didn't bet)
Seat 5: SYC55 folded before Flop (didn't bet)
Seat 6: Weretawe folded before Flop (didn't bet)
Seat 7: slickrick358 folded before Flop (didn't bet)
Seat 8: hachinaglia (button) folded before Flop (didn't bet)
Seat 9: tpdg64 (small blind) folded before Flop



PokerStars Hand #189157879106: Tournament #2361851754, 9000+1000 Hold'em No Limit - Level XV (120/240) - 2018/07/25 21:05:33 ET
Table '2361851754 3' 9-max Seat #9 is the button
Seat 1: Gorilla JB (1204 in chips) 
Seat 2: endler76 (9703 in chips) 
Seat 3: hzane (7404 in chips) 
Seat 4: Nikola197022 (3709 in chips) 
Seat 5: SYC55 (5781 in chips) 
Seat 6: Weretawe (10838 in chips) 
Seat 7: slickrick358 (2190 in chips) 
Seat 8: hachinaglia (530 in chips) is sitting out
Seat 9: tpdg64 (3442 in chips) 
Gorilla JB: posts the ante 24
endler76: posts the ante 24
hzane: posts the ante 24
Nikola197022: posts the ante 24
SYC55: posts the ante 24
Weretawe: posts the ante 24
slickrick358: posts the ante 24
hachinaglia: posts the ante 24
tpdg64: posts the ante 24
Gorilla JB: posts small blind 120
endler76: posts big blind 240
*** HOLE CARDS ***
Dealt to hzane [9h 9d]
hzane: raises 240 to 480
Nikola197022: folds 
SYC55: folds 
Weretawe: calls 480
slickrick358: folds 
hachinaglia: folds 
tpdg64: folds 
Gorilla JB: folds 
endler76: calls 240
*** FLOP *** [7s Qh 8s]
endler76: checks 
hzane: bets 480
Weretawe: folds 
endler76: folds 
Uncalled bet (480) returned to hzane
hzane collected 1776 from pot
*** SUMMARY ***
Total pot 1776 | Rake 0 
Board [7s Qh 8s]
Seat 1: Gorilla JB (small blind) folded before Flop
Seat 2: endler76 (big blind) folded on the Flop
Seat 3: hzane collected (1776)
Seat 4: Nikola197022 folded before Flop (didn't bet)
Seat 5: SYC55 folded before Flop (didn't bet)
Seat 6: Weretawe folded on the Flop
Seat 7: slickrick358 folded before Flop (didn't bet)
Seat 8: hachinaglia folded before Flop (didn't bet)
Seat 9: tpdg64 (button) folded before Flop (didn't bet)



PokerStars Hand #189157893745: Tournament #2361851754, 9000+1000 Hold'em No Limit - Level XV (120/240) - 2018/07/25 21:06:13 ET
Table '2361851754 3' 9-max Seat #1 is the button
Seat 1: Gorilla JB (1060 in chips) 
Seat 2: endler76 (9199 in chips) 
Seat 3: hzane (8676 in chips) 
Seat 4: Nikola197022 (3685 in chips) 
Seat 5: SYC55 (5757 in chips) 
Seat 6: Weretawe (10334 in chips) 
Seat 7: slickrick358 (2166 in chips) 
Seat 8: hachinaglia (506 in chips) is sitting out
Seat 9: tpdg64 (3418 in chips) 
Gorilla JB: posts the ante 24
endler76: posts the ante 24
hzane: posts the ante 24
Nikola197022: posts the ante 24
SYC55: posts the ante 24
Weretawe: posts the ante 24
slickrick358: posts the ante 24
hachinaglia: posts the ante 24
tpdg64: posts the ante 24
endler76: posts small blind 120
hzane: posts big blind 240
*** HOLE CARDS ***
Dealt to hzane [Jh 5s]
Nikola197022: folds 
SYC55: folds 
Weretawe: calls 240
slickrick358: folds 
hachinaglia: folds 
tpdg64: folds 
Gorilla JB: folds 
endler76: calls 120
hzane: checks 
*** FLOP *** [Jd 9c 2h]
endler76: checks 
hzane: bets 480
Weretawe: calls 480
endler76: folds 
*** TURN *** [Jd 9c 2h] [7s]
hzane: checks 
Weretawe: bets 720
hzane: calls 720
*** RIVER *** [Jd 9c 2h 7s] [5c]
hzane: bets 720
Weretawe: raises 720 to 1440
hzane: calls 720
*** SHOW DOWN ***
Weretawe: shows [Jc 9d] (two pair, Jacks and Nines)
hzane: mucks hand 
Weretawe collected 6216 from pot
*** SUMMARY ***
Total pot 6216 | Rake 0 
Board [Jd 9c 2h 7s 5c]
Seat 1: Gorilla JB (button) folded before Flop (didn't bet)
Seat 2: endler76 (small blind) folded on the Flop
Seat 3: hzane (big blind) mucked [Jh 5s]
Seat 4: Nikola197022 folded before Flop (didn't bet)
Seat 5: SYC55 folded before Flop (didn't bet)
Seat 6: Weretawe showed [Jc 9d] and won (6216) with two pair, Jacks and Nines
Seat 7: slickrick358 folded before Flop (didn't bet)
Seat 8: hachinaglia folded before Flop (didn't bet)
Seat 9: tpdg64 folded before Flop (didn't bet)



PokerStars Hand #189157927727: Tournament #2361851754, 9000+1000 Hold'em No Limit - Level XVI (140/280) - 2018/07/25 21:07:44 ET
Table '2361851754 3' 9-max Seat #2 is the button
Seat 1: Gorilla JB (1036 in chips) 
Seat 2: endler76 (8935 in chips) 
Seat 3: hzane (5772 in chips) 
Seat 4: Nikola197022 (3661 in chips) 
Seat 5: SYC55 (5733 in chips) 
Seat 6: Weretawe (13646 in chips) 
Seat 7: slickrick358 (2142 in chips) 
Seat 8: hachinaglia (482 in chips) is sitting out
Seat 9: tpdg64 (3394 in chips) 
Gorilla JB: posts the ante 28
endler76: posts the ante 28
hzane: posts the ante 28
Nikola197022: posts the ante 28
SYC55: posts the ante 28
Weretawe: posts the ante 28
slickrick358: posts the ante 28
hachinaglia: posts the ante 28
tpdg64: posts the ante 28
hzane: posts small blind 140
Nikola197022: posts big blind 280
*** HOLE CARDS ***
Dealt to hzane [6s 4s]
SYC55: folds 
Weretawe: folds 
slickrick358: calls 280
hachinaglia: folds 
tpdg64 has timed out
tpdg64: folds 
Gorilla JB: folds 
endler76: raises 8627 to 8907 and is all-in
hzane: folds 
Nikola197022: folds 
slickrick358: calls 1834 and is all-in
Uncalled bet (6793) returned to endler76
*** FLOP *** [2s Th 7h]
*** TURN *** [2s Th 7h] [5h]
*** RIVER *** [2s Th 7h 5h] [3d]
*** SHOW DOWN ***
slickrick358: shows [Qs 9s] (high card Queen)
endler76: shows [Ks Ac] (high card Ace)
endler76 collected 4900 from pot
*** SUMMARY ***
Total pot 4900 | Rake 0 
Board [2s Th 7h 5h 3d]
Seat 1: Gorilla JB folded before Flop (didn't bet)
Seat 2: endler76 (button) showed [Ks Ac] and won (4900) with high card Ace
Seat 3: hzane (small blind) folded before Flop
Seat 4: Nikola197022 (big blind) folded before Flop
Seat 5: SYC55 folded before Flop (didn't bet)
Seat 6: Weretawe folded before Flop (didn't bet)
Seat 7: slickrick358 showed [Qs 9s] and lost with high card Queen
Seat 8: hachinaglia folded before Flop (didn't bet)
Seat 9: tpdg64 folded before Flop (didn't bet)



PokerStars Hand #189157962104: Tournament #2361851754, 9000+1000 Hold'em No Limit - Level XVI (140/280) - 2018/07/25 21:09:19 ET
Table '2361851754 3' 9-max Seat #3 is the button
Seat 1: Gorilla JB (1008 in chips) 
Seat 2: endler76 (11693 in chips) 
Seat 3: hzane (5604 in chips) 
Seat 4: Nikola197022 (3353 in chips) 
Seat 5: SYC55 (5705 in chips) 
Seat 6: Weretawe (13618 in chips) 
Seat 8: hachinaglia (454 in chips) is sitting out
Seat 9: tpdg64 (3366 in chips) is sitting out
Gorilla JB: posts the ante 28
endler76: posts the ante 28
hzane: posts the ante 28
Nikola197022: posts the ante 28
SYC55: posts the ante 28
Weretawe: posts the ante 28
hachinaglia: posts the ante 28
tpdg64: posts the ante 28
Nikola197022: posts small blind 140
SYC55: posts big blind 280
*** HOLE CARDS ***
Dealt to hzane [6h 9h]
Weretawe: folds 
hachinaglia: folds 
tpdg64: folds 
Gorilla JB: folds 
endler76: folds 
hzane: raises 280 to 560
Nikola197022: folds 
SYC55: folds 
Uncalled bet (280) returned to hzane
hzane collected 924 from pot
*** SUMMARY ***
Total pot 924 | Rake 0 
Seat 1: Gorilla JB folded before Flop (didn't bet)
Seat 2: endler76 folded before Flop (didn't bet)
Seat 3: hzane (button) collected (924)
Seat 4: Nikola197022 (small blind) folded before Flop
Seat 5: SYC55 (big blind) folded before Flop
Seat 6: Weretawe folded before Flop (didn't bet)
Seat 8: hachinaglia folded before Flop (didn't bet)
Seat 9: tpdg64 folded before Flop (didn't bet)



PokerStars Hand #189157971143: Tournament #2361851754, 9000+1000 Hold'em No Limit - Level XVII (160/320) - 2018/07/25 21:09:44 ET
Table '2361851754 3' 9-max Seat #4 is the button
Seat 1: Gorilla JB (980 in chips) 
Seat 2: endler76 (11665 in chips) 
Seat 3: hzane (6220 in chips) 
Seat 4: Nikola197022 (3185 in chips) 
Seat 5: SYC55 (5397 in chips) 
Seat 6: Weretawe (13590 in chips) 
Seat 8: hachinaglia (426 in chips) is sitting out
Seat 9: tpdg64 (3338 in chips) is sitting out
Gorilla JB: posts the ante 32
endler76: posts the ante 32
hzane: posts the ante 32
Nikola197022: posts the ante 32
SYC55: posts the ante 32
Weretawe: posts the ante 32
hachinaglia: posts the ante 32
tpdg64: posts the ante 32
SYC55: posts small blind 160
Weretawe: posts big blind 320
*** HOLE CARDS ***
Dealt to hzane [7s 8h]
hachinaglia: folds 
tpdg64: folds 
Gorilla JB: folds 
endler76: calls 320
hzane: folds 
Nikola197022: calls 320
SYC55: calls 160
Weretawe: checks 
*** FLOP *** [4c 6d Jc]
SYC55: checks 
Weretawe: checks 
endler76: checks 
Nikola197022: checks 
*** TURN *** [4c 6d Jc] [5d]
SYC55: bets 640
Weretawe: calls 640
endler76: calls 640
Nikola197022: calls 640
*** RIVER *** [4c 6d Jc 5d] [4h]
SYC55: checks 
Weretawe: checks 
endler76: checks 
Nikola197022: checks 
*** SHOW DOWN ***
SYC55: shows [Jh 9c] (two pair, Jacks and Fours)
Weretawe: mucks hand 
endler76: mucks hand 
Nikola197022: mucks hand 
SYC55 collected 4096 from pot
*** SUMMARY ***
Total pot 4096 | Rake 0 
Board [4c 6d Jc 5d 4h]
Seat 1: Gorilla JB folded before Flop (didn't bet)
Seat 2: endler76 mucked [8s Qh]
Seat 3: hzane folded before Flop (didn't bet)
Seat 4: Nikola197022 (button) mucked [Qc Ac]
Seat 5: SYC55 (small blind) showed [Jh 9c] and won (4096) with two pair, Jacks and Fours
Seat 6: Weretawe (big blind) mucked [Kh 8d]
Seat 8: hachinaglia folded before Flop (didn't bet)
Seat 9: tpdg64 folded before Flop (didn't bet)



PokerStars Hand #189157995257: Tournament #2361851754, 9000+1000 Hold'em No Limit - Level XVII (160/320) - 2018/07/25 21:10:51 ET
Table '2361851754 3' 9-max Seat #5 is the button
Seat 1: Gorilla JB (948 in chips) 
Seat 2: endler76 (10673 in chips) 
Seat 3: hzane (6188 in chips) 
Seat 4: Nikola197022 (2193 in chips) 
Seat 5: SYC55 (8501 in chips) 
Seat 6: Weretawe (12598 in chips) 
Seat 7: Mr.Cliirf (2118 in chips) is sitting out
Seat 8: hachinaglia (394 in chips) is sitting out
Seat 9: tpdg64 (3306 in chips) is sitting out
Gorilla JB: posts the ante 32
endler76: posts the ante 32
hzane: posts the ante 32
Nikola197022: posts the ante 32
SYC55: posts the ante 32
Weretawe: posts the ante 32
Mr.Cliirf: posts the ante 32
hachinaglia: posts the ante 32
tpdg64: posts the ante 32
Weretawe: posts small blind 160
Mr.Cliirf: posts big blind 320
*** HOLE CARDS ***
Dealt to hzane [Ts 3c]
hachinaglia: folds 
tpdg64: folds 
Gorilla JB: calls 320
endler76: calls 320
hzane: folds 
Nikola197022: folds 
SYC55: raises 8149 to 8469 and is all-in
Weretawe: folds 
Mr.Cliirf: folds 
Gorilla JB: folds 
endler76: folds 
Uncalled bet (8149) returned to SYC55
SYC55 collected 1728 from pot
SYC55: doesn't show hand 
*** SUMMARY ***
Total pot 1728 | Rake 0 
Seat 1: Gorilla JB folded before Flop
Seat 2: endler76 folded before Flop
Seat 3: hzane folded before Flop (didn't bet)
Seat 4: Nikola197022 folded before Flop (didn't bet)
Seat 5: SYC55 (button) collected (1728)
Seat 6: Weretawe (small blind) folded before Flop
Seat 7: Mr.Cliirf (big blind) folded before Flop
Seat 8: hachinaglia folded before Flop (didn't bet)
Seat 9: tpdg64 folded before Flop (didn't bet)



PokerStars Hand #189158006095: Tournament #2361851754, 9000+1000 Hold'em No Limit - Level XVII (160/320) - 2018/07/25 21:11:22 ET
Table '2361851754 3' 9-max Seat #6 is the button
Seat 1: Gorilla JB (596 in chips) 
Seat 2: endler76 (10321 in chips) 
Seat 3: hzane (6156 in chips) 
Seat 4: Nikola197022 (2161 in chips) 
Seat 5: SYC55 (9877 in chips) 
Seat 6: Weretawe (12406 in chips) 
Seat 7: Mr.Cliirf (1766 in chips) is sitting out
Seat 8: hachinaglia (362 in chips) is sitting out
Seat 9: tpdg64 (3274 in chips) 
Gorilla JB: posts the ante 32
endler76: posts the ante 32
hzane: posts the ante 32
Nikola197022: posts the ante 32
SYC55: posts the ante 32
Weretawe: posts the ante 32
Mr.Cliirf: posts the ante 32
hachinaglia: posts the ante 32
tpdg64: posts the ante 32
Mr.Cliirf: posts small blind 160
hachinaglia: posts big blind 320
*** HOLE CARDS ***
Dealt to hzane [Js Td]
tpdg64: calls 320
Gorilla JB: folds 
endler76: folds 
hzane: folds 
Nikola197022: folds 
SYC55: calls 320
Weretawe: calls 320
Mr.Cliirf: folds 
hachinaglia: folds 
*** FLOP *** [As Kc 3c]
tpdg64: checks 
SYC55: checks 
Weretawe: checks 
*** TURN *** [As Kc 3c] [9s]
tpdg64: checks 
SYC55: checks 
Weretawe: checks 
*** RIVER *** [As Kc 3c 9s] [Ac]
tpdg64: checks 
SYC55: checks 
Weretawe: bets 960
tpdg64: calls 960
SYC55: folds 
*** SHOW DOWN ***
Weretawe: shows [Ah 7c] (three of a kind, Aces)
tpdg64: mucks hand 
Weretawe collected 3648 from pot
*** SUMMARY ***
Total pot 3648 | Rake 0 
Board [As Kc 3c 9s Ac]
Seat 1: Gorilla JB folded before Flop (didn't bet)
Seat 2: endler76 folded before Flop (didn't bet)
Seat 3: hzane folded before Flop (didn't bet)
Seat 4: Nikola197022 folded before Flop (didn't bet)
Seat 5: SYC55 folded on the River
Seat 6: Weretawe (button) showed [Ah 7c] and won (3648) with three of a kind, Aces
Seat 7: Mr.Cliirf (small blind) folded before Flop
Seat 8: hachinaglia (big blind) folded before Flop
Seat 9: tpdg64 mucked [Kd Qc]



PokerStars Hand #189158040262: Tournament #2361851754, 9000+1000 Hold'em No Limit - Level XVIII (200/400) - 2018/07/25 21:12:39 ET
Table '2361851754 3' 9-max Seat #7 is the button
Seat 1: Gorilla JB (564 in chips) 
Seat 2: endler76 (10289 in chips) 
Seat 3: hzane (6124 in chips) 
Seat 4: Nikola197022 (2129 in chips) 
Seat 5: SYC55 (9525 in chips) 
Seat 6: Weretawe (14742 in chips) 
Seat 7: Mr.Cliirf (1574 in chips) is sitting out
Seat 8: hachinaglia (10 in chips) is sitting out
Seat 9: tpdg64 (1962 in chips) 
Gorilla JB: posts the ante 40
endler76: posts the ante 40
hzane: posts the ante 40
Nikola197022: posts the ante 40
SYC55: posts the ante 40
Weretawe: posts the ante 40
Mr.Cliirf: posts the ante 40
hachinaglia: posts the ante 10 and is all-in
tpdg64: posts the ante 40
tpdg64: posts big blind 400
*** HOLE CARDS ***
Dealt to hzane [8c Ac]
Gorilla JB: folds 
endler76: folds 
hzane: calls 400
Nikola197022: folds 
SYC55: folds 
Weretawe: calls 400
Mr.Cliirf: folds 
hachinaglia: folds 
tpdg64: checks 
*** FLOP *** [Tc Kh Jd]
tpdg64: checks 
hzane: bets 400
Weretawe: calls 400
tpdg64: folds 
*** TURN *** [Tc Kh Jd] [6d]
hzane: bets 400
Weretawe: calls 400
*** RIVER *** [Tc Kh Jd 6d] [7d]
hzane: bets 800
Weretawe: folds 
Uncalled bet (800) returned to hzane
hzane collected 3130 from pot
hachinaglia finished the tournament in 112th place and received 16000.
*** SUMMARY ***
Total pot 3130 | Rake 0 
Board [Tc Kh Jd 6d 7d]
Seat 1: Gorilla JB folded before Flop (didn't bet)
Seat 2: endler76 folded before Flop (didn't bet)
Seat 3: hzane collected (3130)
Seat 4: Nikola197022 folded before Flop (didn't bet)
Seat 5: SYC55 folded before Flop (didn't bet)
Seat 6: Weretawe folded on the River
Seat 7: Mr.Cliirf (button) folded before Flop (didn't bet)
Seat 8: hachinaglia folded before Flop (didn't bet)
Seat 9: tpdg64 (big blind) folded on the Flop



PokerStars Hand #189158068194: Tournament #2361851754, 9000+1000 Hold'em No Limit - Level XVIII (200/400) - 2018/07/25 21:13:57 ET
Table '2361851754 3' 9-max Seat #9 is the button
Seat 1: Gorilla JB (524 in chips) 
Seat 2: endler76 (10249 in chips) 
Seat 3: hzane (8014 in chips) 
Seat 4: Nikola197022 (2089 in chips) 
Seat 5: SYC55 (9485 in chips) 
Seat 6: Weretawe (13502 in chips) 
Seat 7: Mr.Cliirf (1534 in chips) is sitting out
Seat 9: tpdg64 (1522 in chips) 
Gorilla JB: posts the ante 40
endler76: posts the ante 40
hzane: posts the ante 40
Nikola197022: posts the ante 40
SYC55: posts the ante 40
Weretawe: posts the ante 40
Mr.Cliirf: posts the ante 40
tpdg64: posts the ante 40
Gorilla JB: posts small blind 200
endler76: posts big blind 400
*** HOLE CARDS ***
Dealt to hzane [Kc 5s]
hzane: folds 
Nikola197022: folds 
SYC55: folds 
Weretawe: calls 400
Mr.Cliirf: folds 
tpdg64: folds 
Gorilla JB: calls 200
endler76: checks 
*** FLOP *** [9s 3s As]
Gorilla JB: checks 
endler76: checks 
Weretawe: checks 
*** TURN *** [9s 3s As] [Td]
Gorilla JB: checks 
endler76: checks 
Weretawe: bets 400
Gorilla JB: folds 
endler76: folds 
Uncalled bet (400) returned to Weretawe
Weretawe collected 1520 from pot
Weretawe: doesn't show hand 
*** SUMMARY ***
Total pot 1520 | Rake 0 
Board [9s 3s As Td]
Seat 1: Gorilla JB (small blind) folded on the Turn
Seat 2: endler76 (big blind) folded on the Turn
Seat 3: hzane folded before Flop (didn't bet)
Seat 4: Nikola197022 folded before Flop (didn't bet)
Seat 5: SYC55 folded before Flop (didn't bet)
Seat 6: Weretawe collected (1520)
Seat 7: Mr.Cliirf folded before Flop (didn't bet)
Seat 9: tpdg64 (button) folded before Flop (didn't bet)



PokerStars Hand #189158087861: Tournament #2361851754, 9000+1000 Hold'em No Limit - Level XVIII (200/400) - 2018/07/25 21:14:53 ET
Table '2361851754 3' 9-max Seat #1 is the button
Seat 1: Gorilla JB (84 in chips) 
Seat 2: endler76 (9809 in chips) 
Seat 3: hzane (7974 in chips) 
Seat 4: Nikola197022 (2049 in chips) 
Seat 5: SYC55 (9445 in chips) 
Seat 6: Weretawe (14582 in chips) 
Seat 7: Mr.Cliirf (1494 in chips) is sitting out
Seat 9: tpdg64 (1482 in chips) 
Gorilla JB: posts the ante 40
endler76: posts the ante 40
hzane: posts the ante 40
Nikola197022: posts the ante 40
SYC55: posts the ante 40
Weretawe: posts the ante 40
Mr.Cliirf: posts the ante 40
tpdg64: posts the ante 40
endler76: posts small blind 200
hzane: posts big blind 400
*** HOLE CARDS ***
Dealt to hzane [2h 2c]
Nikola197022: folds 
SYC55: folds 
Weretawe: calls 400
Mr.Cliirf: folds 
tpdg64: folds 
Gorilla JB: folds 
endler76: calls 200
hzane: checks 
*** FLOP *** [4s 3d 2d]
endler76: bets 400
hzane: calls 400
Weretawe: folds 
*** TURN *** [4s 3d 2d] [6d]
endler76: bets 400
hzane: calls 400
*** RIVER *** [4s 3d 2d 6d] [7c]
endler76: checks 
hzane: bets 800
endler76: folds 
Uncalled bet (800) returned to hzane
hzane collected 3120 from pot
*** SUMMARY ***
Total pot 3120 | Rake 0 
Board [4s 3d 2d 6d 7c]
Seat 1: Gorilla JB (button) folded before Flop (didn't bet)
Seat 2: endler76 (small blind) folded on the River
Seat 3: hzane (big blind) collected (3120)
Seat 4: Nikola197022 folded before Flop (didn't bet)
Seat 5: SYC55 folded before Flop (didn't bet)
Seat 6: Weretawe folded on the Flop
Seat 7: Mr.Cliirf folded before Flop (didn't bet)
Seat 9: tpdg64 folded before Flop (didn't bet)



PokerStars Hand #189158109182: Tournament #2361851754, 9000+1000 Hold'em No Limit - Level XIX (250/500) - 2018/07/25 21:15:53 ET
Table '2361851754 3' 9-max Seat #2 is the button
Seat 1: Gorilla JB (44 in chips) 
Seat 2: endler76 (8569 in chips) 
Seat 3: hzane (9854 in chips) 
Seat 4: Nikola197022 (2009 in chips) 
Seat 5: SYC55 (9405 in chips) 
Seat 6: Weretawe (14142 in chips) 
Seat 7: Mr.Cliirf (1454 in chips) is sitting out
Seat 8: poker rana (4508 in chips) 
Seat 9: tpdg64 (1442 in chips) 
Gorilla JB: posts the ante 44 and is all-in
endler76: posts the ante 50
hzane: posts the ante 50
Nikola197022: posts the ante 50
SYC55: posts the ante 50
Weretawe: posts the ante 50
Mr.Cliirf: posts the ante 50
poker rana: posts the ante 50
tpdg64: posts the ante 50
hzane: posts small blind 250
Nikola197022: posts big blind 500
*** HOLE CARDS ***
Dealt to hzane [9h Ah]
SYC55: folds 
Weretawe: calls 500
Mr.Cliirf: folds 
poker rana: folds 
tpdg64: folds 
endler76: raises 1000 to 1500
hzane: folds 
Nikola197022: folds 
Weretawe has timed out
Weretawe: folds 
Uncalled bet (1000) returned to endler76
*** FLOP *** [9c Td 9d]
*** TURN *** [9c Td 9d] [2c]
*** RIVER *** [9c Td 9d 2c] [Kc]
*** SHOW DOWN ***
endler76: shows [Qh 5s] (a pair of Nines)
endler76 collected 1798 from side pot
Gorilla JB: shows [6s 2d] (two pair, Nines and Deuces)
Gorilla JB collected 396 from main pot
*** SUMMARY ***
Total pot 2194 Main pot 396. Side pot 1798. | Rake 0 
Board [9c Td 9d 2c Kc]
Seat 1: Gorilla JB showed [6s 2d] and won (396) with two pair, Nines and Deuces
Seat 2: endler76 (button) showed [Qh 5s] and won (1798) with a pair of Nines
Seat 3: hzane (small blind) folded before Flop
Seat 4: Nikola197022 (big blind) folded before Flop
Seat 5: SYC55 folded before Flop (didn't bet)
Seat 6: Weretawe folded before Flop
Seat 7: Mr.Cliirf folded before Flop (didn't bet)
Seat 8: poker rana folded before Flop (didn't bet)
Seat 9: tpdg64 folded before Flop (didn't bet)



PokerStars Hand #189158127472: Tournament #2361851754, 9000+1000 Hold'em No Limit - Level XIX (250/500) - 2018/07/25 21:16:44 ET
Table '2361851754 3' 9-max Seat #3 is the button
Seat 1: Gorilla JB (396 in chips) 
Seat 2: endler76 (9817 in chips) 
Seat 3: hzane (9554 in chips) 
Seat 4: Nikola197022 (1459 in chips) 
Seat 5: SYC55 (9355 in chips) 
Seat 6: Weretawe (13592 in chips) is sitting out
Seat 7: Mr.Cliirf (1404 in chips) is sitting out
Seat 8: poker rana (4458 in chips) 
Seat 9: tpdg64 (1392 in chips) 
Gorilla JB: posts the ante 50
endler76: posts the ante 50
hzane: posts the ante 50
Nikola197022: posts the ante 50
SYC55: posts the ante 50
Weretawe: posts the ante 50
Mr.Cliirf: posts the ante 50
poker rana: posts the ante 50
tpdg64: posts the ante 50
Nikola197022: posts small blind 250
SYC55: posts big blind 500
*** HOLE CARDS ***
Dealt to hzane [9h 7h]
Weretawe: folds 
Mr.Cliirf: folds 
poker rana: folds 
tpdg64: folds 
Gorilla JB: calls 346 and is all-in
endler76: folds 
hzane: raises 500 to 1000
Nikola197022: folds 
SYC55: folds 
Uncalled bet (500) returned to hzane
*** FLOP *** [8h 2h Qs]
*** TURN *** [8h 2h Qs] [6d]
*** RIVER *** [8h 2h Qs 6d] [4h]
*** SHOW DOWN ***
hzane: shows [9h 7h] (a flush, Nine high)
hzane collected 308 from side pot
Gorilla JB: shows [Td Tc] (a pair of Tens)
hzane collected 1738 from main pot
Gorilla JB finished the tournament in 100th place and received 16000.
*** SUMMARY ***
Total pot 2046 Main pot 1738. Side pot 308. | Rake 0 
Board [8h 2h Qs 6d 4h]
Seat 1: Gorilla JB showed [Td Tc] and lost with a pair of Tens
Seat 2: endler76 folded before Flop (didn't bet)
Seat 3: hzane (button) showed [9h 7h] and won (2046) with a flush, Nine high
Seat 4: Nikola197022 (small blind) folded before Flop
Seat 5: SYC55 (big blind) folded before Flop
Seat 6: Weretawe folded before Flop (didn't bet)
Seat 7: Mr.Cliirf folded before Flop (didn't bet)
Seat 8: poker rana folded before Flop (didn't bet)
Seat 9: tpdg64 folded before Flop (didn't bet)



PokerStars Hand #189158153648: Tournament #2361851754, 9000+1000 Hold'em No Limit - Level XIX (250/500) - 2018/07/25 21:17:58 ET
Table '2361851754 12' 9-max Seat #5 is the button
Seat 1: equeir88 (6830 in chips) 
Seat 2: SmokeyLMB (12960 in chips) 
Seat 3: Sócartabaixa (9054 in chips) 
Seat 4: hzane (11050 in chips) 
Seat 5: pepe_duro59 (700 in chips) 
Seat 6: makko1616 (3087 in chips) is sitting out
Seat 7: felina918 (7473 in chips) 
Seat 8: almavale (8360 in chips) 
Seat 9: solcosmico13 (12869 in chips) 
equeir88: posts the ante 50
SmokeyLMB: posts the ante 50
Sócartabaixa: posts the ante 50
hzane: posts the ante 50
pepe_duro59: posts the ante 50
makko1616: posts the ante 50
felina918: posts the ante 50
almavale: posts the ante 50
solcosmico13: posts the ante 50
makko1616: posts small blind 250
felina918: posts big blind 500
*** HOLE CARDS ***
Dealt to hzane [8c 9c]
almavale: folds 
solcosmico13: calls 500
equeir88: calls 500
SmokeyLMB: folds 
Sócartabaixa: folds 
hzane: calls 500
pepe_duro59: folds 
makko1616: folds 
felina918: raises 500 to 1000
solcosmico13: calls 500
equeir88: calls 500
hzane: calls 500
*** FLOP *** [Qc 7h 9h]
felina918: bets 500
solcosmico13: folds 
equeir88: raises 5280 to 5780 and is all-in
hzane: folds 
felina918: calls 5280
*** TURN *** [Qc 7h 9h] [2s]
*** RIVER *** [Qc 7h 9h 2s] [4d]
*** SHOW DOWN ***
felina918: shows [Kc As] (high card Ace)
equeir88: shows [Qs 9s] (two pair, Queens and Nines)
equeir88 collected 16260 from pot
*** SUMMARY ***
Total pot 16260 | Rake 0 
Board [Qc 7h 9h 2s 4d]
Seat 1: equeir88 showed [Qs 9s] and won (16260) with two pair, Queens and Nines
Seat 2: SmokeyLMB folded before Flop (didn't bet)
Seat 3: Sócartabaixa folded before Flop (didn't bet)
Seat 4: hzane folded on the Flop
Seat 5: pepe_duro59 (button) folded before Flop (didn't bet)
Seat 6: makko1616 (small blind) folded before Flop
Seat 7: felina918 (big blind) showed [Kc As] and lost with high card Ace
Seat 8: almavale folded before Flop (didn't bet)
Seat 9: solcosmico13 folded on the Flop



PokerStars Hand #189158179923: Tournament #2361851754, 9000+1000 Hold'em No Limit - Level XX (300/600) - 2018/07/25 21:19:13 ET
Table '2361851754 12' 9-max Seat #6 is the button
Seat 1: equeir88 (16260 in chips) 
Seat 2: SmokeyLMB (12910 in chips) 
Seat 3: Sócartabaixa (9004 in chips) 
Seat 4: hzane (10000 in chips) 
Seat 5: pepe_duro59 (650 in chips) 
Seat 6: makko1616 (2787 in chips) is sitting out
Seat 7: felina918 (643 in chips) 
Seat 8: almavale (8310 in chips) 
Seat 9: solcosmico13 (11819 in chips) 
equeir88: posts the ante 60
SmokeyLMB: posts the ante 60
Sócartabaixa: posts the ante 60
hzane: posts the ante 60
pepe_duro59: posts the ante 60
makko1616: posts the ante 60
felina918: posts the ante 60
almavale: posts the ante 60
solcosmico13: posts the ante 60
felina918: posts small blind 300
almavale: posts big blind 600
*** HOLE CARDS ***
Dealt to hzane [Kd 2c]
solcosmico13: folds 
equeir88: calls 600
SmokeyLMB: folds 
Sócartabaixa: calls 600
hzane: folds 
pepe_duro59: folds 
makko1616: folds 
felina918: calls 283 and is all-in
almavale: checks 
*** FLOP *** [3d 9s Th]
almavale: bets 1200
equeir88: folds 
Sócartabaixa: calls 1200
*** TURN *** [3d 9s Th] [As]
almavale: checks 
Sócartabaixa: checks 
*** RIVER *** [3d 9s Th As] [Kh]
almavale: bets 1200
Sócartabaixa: calls 1200
*** SHOW DOWN ***
almavale: shows [Tc 4s] (a pair of Tens)
Sócartabaixa: mucks hand 
almavale collected 4851 from side pot
felina918: mucks hand 
almavale collected 2872 from main pot
felina918 finished the tournament in 91st place and received 18000.
*** SUMMARY ***
Total pot 7723 Main pot 2872. Side pot 4851. | Rake 0 
Board [3d 9s Th As Kh]
Seat 1: equeir88 folded on the Flop
Seat 2: SmokeyLMB folded before Flop (didn't bet)
Seat 3: Sócartabaixa mucked [8h 8d]
Seat 4: hzane folded before Flop (didn't bet)
Seat 5: pepe_duro59 folded before Flop (didn't bet)
Seat 6: makko1616 (button) folded before Flop (didn't bet)
Seat 7: felina918 (small blind) mucked [7s 9d]
Seat 8: almavale (big blind) showed [Tc 4s] and won (7723) with a pair of Tens
Seat 9: solcosmico13 folded before Flop (didn't bet)



PokerStars Hand #189158205069: Tournament #2361851754, 9000+1000 Hold'em No Limit - Level XX (300/600) - 2018/07/25 21:20:24 ET
Table '2361851754 11' 9-max Seat #7 is the button
Seat 1: SYC55 (8025 in chips) 
Seat 2: flaviobakana (6038 in chips) 
Seat 3: nicapete (31 in chips) is sitting out
Seat 4: pepe_duro59 (590 in chips) 
Seat 5: hzane (9940 in chips) 
Seat 6: ramonsus (21027 in chips) 
Seat 7: Luian986 (8 in chips) is sitting out
Seat 8: pezrojo73 (12845 in chips) is sitting out
Seat 9: MikeVin100 (37023 in chips) 
SYC55: posts the ante 60
flaviobakana: posts the ante 60
nicapete: posts the ante 31 and is all-in
pepe_duro59: posts the ante 60
hzane: posts the ante 60
ramonsus: posts the ante 60
Luian986: posts the ante 8 and is all-in
pezrojo73: posts the ante 60
MikeVin100: posts the ante 60
pezrojo73: posts small blind 300
MikeVin100: posts big blind 600
*** HOLE CARDS ***
Dealt to hzane [4c Jc]
SYC55: raises 7365 to 7965 and is all-in
flaviobakana: folds 
nicapete: folds 
pepe_duro59: folds 
hzane: folds 
ramonsus: folds 
Luian986: folds 
pezrojo73: folds 
MikeVin100: folds 
Uncalled bet (7365) returned to SYC55
SYC55 collected 1959 from pot
nicapete finished the tournament in 88th place and received 18000.
Luian986 finished the tournament in 89th place and received 18000.
SYC55: doesn't show hand 
*** SUMMARY ***
Total pot 1959 | Rake 0 
Seat 1: SYC55 collected (1959)
Seat 2: flaviobakana folded before Flop (didn't bet)
Seat 3: nicapete folded before Flop (didn't bet)
Seat 4: pepe_duro59 folded before Flop (didn't bet)
Seat 5: hzane folded before Flop (didn't bet)
Seat 6: ramonsus folded before Flop (didn't bet)
Seat 7: Luian986 (button) folded before Flop (didn't bet)
Seat 8: pezrojo73 (small blind) folded before Flop
Seat 9: MikeVin100 (big blind) folded before Flop



PokerStars Hand #189158218331: Tournament #2361851754, 9000+1000 Hold'em No Limit - Level XX (300/600) - 2018/07/25 21:21:02 ET
Table '2361851754 11' 9-max Seat #8 is the button
Seat 1: SYC55 (9324 in chips) 
Seat 2: flaviobakana (5978 in chips) 
Seat 4: pepe_duro59 (530 in chips) 
Seat 5: hzane (9880 in chips) 
Seat 6: ramonsus (20967 in chips) 
Seat 7: snowfox568 (4552 in chips) is sitting out
Seat 8: pezrojo73 (12485 in chips) 
Seat 9: MikeVin100 (36363 in chips) 
SYC55: posts the ante 60
flaviobakana: posts the ante 60
pepe_duro59: posts the ante 60
hzane: posts the ante 60
ramonsus: posts the ante 60
snowfox568: posts the ante 60
pezrojo73: posts the ante 60
MikeVin100: posts the ante 60
MikeVin100: posts small blind 300
SYC55: posts big blind 600
*** HOLE CARDS ***
Dealt to hzane [4h 9h]
flaviobakana: folds 
pepe_duro59: folds 
hzane: folds 
ramonsus: calls 600
snowfox568: folds 
pezrojo73 is disconnected 
pezrojo73 has timed out while disconnected
pezrojo73: folds 
MikeVin100: folds 
SYC55: checks 
*** FLOP *** [4s Ts 3c]
SYC55: checks 
ramonsus: bets 4200
SYC55: folds 
Uncalled bet (4200) returned to ramonsus
ramonsus collected 1980 from pot
*** SUMMARY ***
Total pot 1980 | Rake 0 
Board [4s Ts 3c]
Seat 1: SYC55 (big blind) folded on the Flop
Seat 2: flaviobakana folded before Flop (didn't bet)
Seat 4: pepe_duro59 folded before Flop (didn't bet)
Seat 5: hzane folded before Flop (didn't bet)
Seat 6: ramonsus collected (1980)
Seat 7: snowfox568 folded before Flop (didn't bet)
Seat 8: pezrojo73 (button) folded before Flop (didn't bet)
Seat 9: MikeVin100 (small blind) folded before Flop



PokerStars Hand #189158237293: Tournament #2361851754, 9000+1000 Hold'em No Limit - Level XXI (350/700) - 2018/07/25 21:21:56 ET
Table '2361851754 11' 9-max Seat #9 is the button
Seat 1: SYC55 (8664 in chips) 
Seat 2: flaviobakana (5918 in chips) 
Seat 4: pepe_duro59 (470 in chips) 
Seat 5: hzane (9820 in chips) 
Seat 6: ramonsus (22287 in chips) 
Seat 7: snowfox568 (4492 in chips) is sitting out
Seat 8: pezrojo73 (12425 in chips) is sitting out
Seat 9: MikeVin100 (36003 in chips) 
SYC55: posts the ante 70
flaviobakana: posts the ante 70
pepe_duro59: posts the ante 70
hzane: posts the ante 70
ramonsus: posts the ante 70
snowfox568: posts the ante 70
pezrojo73: posts the ante 70
MikeVin100: posts the ante 70
SYC55: posts small blind 350
flaviobakana: posts big blind 700
*** HOLE CARDS ***
Dealt to hzane [2s Tc]
pepe_duro59: folds 
hzane: folds 
ramonsus: folds 
snowfox568: folds 
pezrojo73: folds 
MikeVin100: raises 2310 to 3010
SYC55: folds 
flaviobakana: folds 
Uncalled bet (2310) returned to MikeVin100
MikeVin100 collected 2310 from pot
MikeVin100: doesn't show hand 
*** SUMMARY ***
Total pot 2310 | Rake 0 
Seat 1: SYC55 (small blind) folded before Flop
Seat 2: flaviobakana (big blind) folded before Flop
Seat 4: pepe_duro59 folded before Flop (didn't bet)
Seat 5: hzane folded before Flop (didn't bet)
Seat 6: ramonsus folded before Flop (didn't bet)
Seat 7: snowfox568 folded before Flop (didn't bet)
Seat 8: pezrojo73 folded before Flop (didn't bet)
Seat 9: MikeVin100 (button) collected (2310)



PokerStars Hand #189158249296: Tournament #2361851754, 9000+1000 Hold'em No Limit - Level XXI (350/700) - 2018/07/25 21:22:30 ET
Table '2361851754 11' 9-max Seat #1 is the button
Seat 1: SYC55 (8244 in chips) 
Seat 2: flaviobakana (5148 in chips) 
Seat 3: ordnasAA (9006 in chips) 
Seat 4: pepe_duro59 (400 in chips) 
Seat 5: hzane (9750 in chips) 
Seat 6: ramonsus (22217 in chips) 
Seat 7: snowfox568 (4422 in chips) is sitting out
Seat 8: pezrojo73 (12355 in chips) is sitting out
Seat 9: MikeVin100 (37543 in chips) 
SYC55: posts the ante 70
flaviobakana: posts the ante 70
ordnasAA: posts the ante 70
pepe_duro59: posts the ante 70
hzane: posts the ante 70
ramonsus: posts the ante 70
snowfox568: posts the ante 70
pezrojo73: posts the ante 70
MikeVin100: posts the ante 70
flaviobakana: posts small blind 350
ordnasAA: posts big blind 700
*** HOLE CARDS ***
Dealt to hzane [5s 4c]
pepe_duro59: calls 330 and is all-in
hzane: folds 
ramonsus: calls 700
snowfox568: folds 
pezrojo73: folds 
MikeVin100: folds 
SYC55: folds 
flaviobakana: calls 350
ordnasAA: checks 
*** FLOP *** [6d 4s 7c]
flaviobakana: bets 700
ordnasAA: folds 
ramonsus: calls 700
*** TURN *** [6d 4s 7c] [5d]
flaviobakana: bets 2100
ramonsus: folds 
Uncalled bet (2100) returned to flaviobakana
*** RIVER *** [6d 4s 7c 5d] [8h]
*** SHOW DOWN ***
flaviobakana: shows [9h 8s] (a straight, Five to Nine)
flaviobakana collected 2510 from side pot
pepe_duro59: shows [8d 9d] (a straight, Five to Nine)
flaviobakana collected 975 from main pot
pepe_duro59 collected 975 from main pot
*** SUMMARY ***
Total pot 4460 Main pot 1950. Side pot 2510. | Rake 0 
Board [6d 4s 7c 5d 8h]
Seat 1: SYC55 (button) folded before Flop (didn't bet)
Seat 2: flaviobakana (small blind) showed [9h 8s] and won (3485) with a straight, Five to Nine
Seat 3: ordnasAA (big blind) folded on the Flop
Seat 4: pepe_duro59 showed [8d 9d] and won (975) with a straight, Five to Nine
Seat 5: hzane folded before Flop (didn't bet)
Seat 6: ramonsus folded on the Turn
Seat 7: snowfox568 folded before Flop (didn't bet)
Seat 8: pezrojo73 folded before Flop (didn't bet)
Seat 9: MikeVin100 folded before Flop (didn't bet)



PokerStars Hand #189158266152: Tournament #2361851754, 9000+1000 Hold'em No Limit - Level XXI (350/700) - 2018/07/25 21:23:17 ET
Table '2361851754 11' 9-max Seat #2 is the button
Seat 1: SYC55 (8174 in chips) 
Seat 2: flaviobakana (7163 in chips) 
Seat 3: ordnasAA (8236 in chips) 
Seat 4: pepe_duro59 (975 in chips) 
Seat 5: hzane (9680 in chips) 
Seat 6: ramonsus (20747 in chips) 
Seat 7: snowfox568 (4352 in chips) is sitting out
Seat 8: pezrojo73 (12285 in chips) is sitting out
Seat 9: MikeVin100 (37473 in chips) 
SYC55: posts the ante 70
flaviobakana: posts the ante 70
ordnasAA: posts the ante 70
pepe_duro59: posts the ante 70
hzane: posts the ante 70
ramonsus: posts the ante 70
snowfox568: posts the ante 70
pezrojo73: posts the ante 70
MikeVin100: posts the ante 70
ordnasAA: posts small blind 350
pepe_duro59: posts big blind 700
*** HOLE CARDS ***
Dealt to hzane [2c 6c]
hzane: folds 
ramonsus: calls 700
snowfox568: folds 
pezrojo73: folds 
MikeVin100: folds 
SYC55: calls 700
flaviobakana: calls 700
ordnasAA: calls 350
pepe_duro59: checks 
*** FLOP *** [Ts 7c Qh]
ordnasAA: checks 
pepe_duro59: checks 
ramonsus: checks 
SYC55: checks 
flaviobakana: checks 
*** TURN *** [Ts 7c Qh] [Jc]
ordnasAA: checks 
pepe_duro59: bets 205 and is all-in
ramonsus: folds 
SYC55: folds 
flaviobakana: calls 205
ordnasAA: calls 205
*** RIVER *** [Ts 7c Qh Jc] [Kh]
ordnasAA: checks 
flaviobakana: bets 1400
ordnasAA: folds 
Uncalled bet (1400) returned to flaviobakana
*** SHOW DOWN ***
flaviobakana: shows [Ad 2s] (a straight, Ten to Ace)
pepe_duro59: shows [Qs Ks] (two pair, Kings and Queens)
flaviobakana collected 4745 from pot
pepe_duro59 finished the tournament in 71st place and received 23000.
*** SUMMARY ***
Total pot 4745 | Rake 0 
Board [Ts 7c Qh Jc Kh]
Seat 1: SYC55 folded on the Turn
Seat 2: flaviobakana (button) showed [Ad 2s] and won (4745) with a straight, Ten to Ace
Seat 3: ordnasAA (small blind) folded on the River
Seat 4: pepe_duro59 (big blind) showed [Qs Ks] and lost with two pair, Kings and Queens
Seat 5: hzane folded before Flop (didn't bet)
Seat 6: ramonsus folded on the Turn
Seat 7: snowfox568 folded before Flop (didn't bet)
Seat 8: pezrojo73 folded before Flop (didn't bet)
Seat 9: MikeVin100 folded before Flop (didn't bet)



PokerStars Hand #189158296870: Tournament #2361851754, 9000+1000 Hold'em No Limit - Level XXII (400/800) - 2018/07/25 21:24:44 ET
Table '2361851754 11' 9-max Seat #3 is the button
Seat 1: SYC55 (7404 in chips) 
Seat 2: flaviobakana (10933 in chips) 
Seat 3: ordnasAA (7261 in chips) 
Seat 5: hzane (9610 in chips) 
Seat 6: ramonsus (19977 in chips) 
Seat 7: snowfox568 (4282 in chips) is sitting out
Seat 8: pezrojo73 (12215 in chips) is sitting out
Seat 9: MikeVin100 (37403 in chips) 
SYC55: posts the ante 80
flaviobakana: posts the ante 80
ordnasAA: posts the ante 80
hzane: posts the ante 80
ramonsus: posts the ante 80
snowfox568: posts the ante 80
pezrojo73: posts the ante 80
MikeVin100: posts the ante 80
hzane: posts small blind 400
ramonsus: posts big blind 800
*** HOLE CARDS ***
Dealt to hzane [7h Qh]
snowfox568: folds 
pezrojo73: folds 
MikeVin100: calls 800
SYC55: folds 
flaviobakana: folds 
ordnasAA: folds 
hzane: folds 
ramonsus: raises 1600 to 2400
MikeVin100: calls 1600
*** FLOP *** [Ah 7c 6c]
ramonsus: bets 800
MikeVin100: calls 800
*** TURN *** [Ah 7c 6c] [8s]
ramonsus: bets 1600
MikeVin100: calls 1600
*** RIVER *** [Ah 7c 6c 8s] [Qs]
ramonsus: bets 2400
MikeVin100: folds 
Uncalled bet (2400) returned to ramonsus
ramonsus collected 10640 from pot
*** SUMMARY ***
Total pot 10640 | Rake 0 
Board [Ah 7c 6c 8s Qs]
Seat 1: SYC55 folded before Flop (didn't bet)
Seat 2: flaviobakana folded before Flop (didn't bet)
Seat 3: ordnasAA (button) folded before Flop (didn't bet)
Seat 5: hzane (small blind) folded before Flop
Seat 6: ramonsus (big blind) collected (10640)
Seat 7: snowfox568 folded before Flop (didn't bet)
Seat 8: pezrojo73 folded before Flop (didn't bet)
Seat 9: MikeVin100 folded on the River



PokerStars Hand #189158315813: Tournament #2361851754, 9000+1000 Hold'em No Limit - Level XXII (400/800) - 2018/07/25 21:25:38 ET
Table '2361851754 11' 9-max Seat #5 is the button
Seat 1: SYC55 (7324 in chips) 
Seat 2: flaviobakana (10853 in chips) 
Seat 3: ordnasAA (7181 in chips) 
Seat 5: hzane (9130 in chips) 
Seat 6: ramonsus (25737 in chips) 
Seat 7: snowfox568 (4202 in chips) is sitting out
Seat 8: pezrojo73 (12135 in chips) is sitting out
Seat 9: MikeVin100 (32523 in chips) 
SYC55: posts the ante 80
flaviobakana: posts the ante 80
ordnasAA: posts the ante 80
hzane: posts the ante 80
ramonsus: posts the ante 80
snowfox568: posts the ante 80
pezrojo73: posts the ante 80
MikeVin100: posts the ante 80
ramonsus: posts small blind 400
snowfox568: posts big blind 800
*** HOLE CARDS ***
Dealt to hzane [8h Kd]
pezrojo73: folds 
MikeVin100: folds 
SYC55: folds 
flaviobakana: folds 
ordnasAA: calls 800
hzane: calls 800
ramonsus: calls 400
snowfox568: folds 
*** FLOP *** [Ts 9d 5d]
ramonsus: checks 
ordnasAA: checks 
hzane: checks 
*** TURN *** [Ts 9d 5d] [9h]
ramonsus: checks 
ordnasAA: checks 
hzane: checks 
*** RIVER *** [Ts 9d 5d 9h] [Ah]
ramonsus: checks 
ordnasAA: checks 
hzane: bets 1600
ramonsus: calls 1600
ordnasAA: folds 
*** SHOW DOWN ***
hzane: shows [8h Kd] (a pair of Nines)
ramonsus: mucks hand 
hzane collected 7040 from pot
*** SUMMARY ***
Total pot 7040 | Rake 0 
Board [Ts 9d 5d 9h Ah]
Seat 1: SYC55 folded before Flop (didn't bet)
Seat 2: flaviobakana folded before Flop (didn't bet)
Seat 3: ordnasAA folded on the River
Seat 5: hzane (button) showed [8h Kd] and won (7040) with a pair of Nines
Seat 6: ramonsus (small blind) mucked [6s 3c]
Seat 7: snowfox568 (big blind) folded before Flop
Seat 8: pezrojo73 folded before Flop (didn't bet)
Seat 9: MikeVin100 folded before Flop (didn't bet)



PokerStars Hand #189158331821: Tournament #2361851754, 9000+1000 Hold'em No Limit - Level XXII (400/800) - 2018/07/25 21:26:25 ET
Table '2361851754 11' 9-max Seat #6 is the button
Seat 1: SYC55 (7244 in chips) 
Seat 2: flaviobakana (10773 in chips) 
Seat 3: ordnasAA (6301 in chips) 
Seat 5: hzane (13690 in chips) 
Seat 6: ramonsus (23257 in chips) 
Seat 7: snowfox568 (3322 in chips) is sitting out
Seat 8: pezrojo73 (12055 in chips) is sitting out
Seat 9: MikeVin100 (32443 in chips) 
SYC55: posts the ante 80
flaviobakana: posts the ante 80
ordnasAA: posts the ante 80
hzane: posts the ante 80
ramonsus: posts the ante 80
snowfox568: posts the ante 80
pezrojo73: posts the ante 80
MikeVin100: posts the ante 80
snowfox568: posts small blind 400
pezrojo73: posts big blind 800
*** HOLE CARDS ***
Dealt to hzane [Qh 2s]
MikeVin100: raises 2640 to 3440
SYC55: folds 
flaviobakana: calls 3440
ordnasAA: folds 
hzane: folds 
ramonsus: folds 
snowfox568: folds 
pezrojo73: folds 
*** FLOP *** [Ad Td 7c]
MikeVin100: checks 
flaviobakana: bets 7253 and is all-in
MikeVin100: calls 7253
*** TURN *** [Ad Td 7c] [8d]
*** RIVER *** [Ad Td 7c 8d] [8s]
*** SHOW DOWN ***
MikeVin100: shows [Th Tc] (a full house, Tens full of Eights)
flaviobakana: shows [Ac 9c] (two pair, Aces and Eights)
MikeVin100 collected 23226 from pot
flaviobakana finished the tournament in 65th place and received 23000.
*** SUMMARY ***
Total pot 23226 | Rake 0 
Board [Ad Td 7c 8d 8s]
Seat 1: SYC55 folded before Flop (didn't bet)
Seat 2: flaviobakana showed [Ac 9c] and lost with two pair, Aces and Eights
Seat 3: ordnasAA folded before Flop (didn't bet)
Seat 5: hzane folded before Flop (didn't bet)
Seat 6: ramonsus (button) folded before Flop (didn't bet)
Seat 7: snowfox568 (small blind) folded before Flop
Seat 8: pezrojo73 (big blind) folded before Flop
Seat 9: MikeVin100 showed [Th Tc] and won (23226) with a full house, Tens full of Eights



PokerStars Hand #189158345826: Tournament #2361851754, 9000+1000 Hold'em No Limit - Level XXII (400/800) - 2018/07/25 21:27:05 ET
Table '2361851754 11' 9-max Seat #7 is the button
Seat 1: SYC55 (7164 in chips) 
Seat 3: ordnasAA (6221 in chips) 
Seat 5: hzane (13610 in chips) 
Seat 6: ramonsus (23177 in chips) 
Seat 7: snowfox568 (2842 in chips) is sitting out
Seat 8: pezrojo73 (11175 in chips) is sitting out
Seat 9: MikeVin100 (44896 in chips) 
SYC55: posts the ante 80
ordnasAA: posts the ante 80
hzane: posts the ante 80
ramonsus: posts the ante 80
snowfox568: posts the ante 80
pezrojo73: posts the ante 80
MikeVin100: posts the ante 80
pezrojo73: posts small blind 400
MikeVin100: posts big blind 800
*** HOLE CARDS ***
Dealt to hzane [Jc 3s]
SYC55: folds 
ordnasAA: folds 
hzane: folds 
ramonsus: calls 800
snowfox568: folds 
pezrojo73: folds 
MikeVin100: checks 
*** FLOP *** [9s Jd 3d]
MikeVin100: checks 
ramonsus: bets 1600
MikeVin100: calls 1600
*** TURN *** [9s Jd 3d] [6h]
MikeVin100: checks 
ramonsus: checks 
*** RIVER *** [9s Jd 3d 6h] [4s]
MikeVin100: bets 800
ramonsus: calls 800
*** SHOW DOWN ***
MikeVin100: shows [9d 2h] (a pair of Nines)
ramonsus: mucks hand 
MikeVin100 collected 7360 from pot
*** SUMMARY ***
Total pot 7360 | Rake 0 
Board [9s Jd 3d 6h 4s]
Seat 1: SYC55 folded before Flop (didn't bet)
Seat 3: ordnasAA folded before Flop (didn't bet)
Seat 5: hzane folded before Flop (didn't bet)
Seat 6: ramonsus mucked [Qc Ts]
Seat 7: snowfox568 (button) folded before Flop (didn't bet)
Seat 8: pezrojo73 (small blind) folded before Flop
Seat 9: MikeVin100 (big blind) showed [9d 2h] and won (7360) with a pair of Nines



PokerStars Hand #189158357742: Tournament #2361851754, 9000+1000 Hold'em No Limit - Level XXIII (500/1000) - 2018/07/25 21:27:39 ET
Table '2361851754 11' 9-max Seat #8 is the button
Seat 1: SYC55 (7084 in chips) 
Seat 2: Mateus at (30998 in chips) 
Seat 3: ordnasAA (6141 in chips) 
Seat 4: makko1616 (967 in chips) is sitting out
Seat 5: hzane (13530 in chips) 
Seat 6: ramonsus (19897 in chips) 
Seat 7: snowfox568 (2762 in chips) is sitting out
Seat 8: pezrojo73 (10695 in chips) 
Seat 9: MikeVin100 (48976 in chips) 
SYC55: posts the ante 100
Mateus at: posts the ante 100
ordnasAA: posts the ante 100
makko1616: posts the ante 100
hzane: posts the ante 100
ramonsus: posts the ante 100
snowfox568: posts the ante 100
pezrojo73: posts the ante 100
MikeVin100: posts the ante 100
MikeVin100: posts small blind 500
SYC55: posts big blind 1000
*** HOLE CARDS ***
Dealt to hzane [2s Tc]
Mateus at: calls 1000
ordnasAA: folds 
makko1616: folds 
hzane: folds 
ramonsus: folds 
snowfox568: folds 
pezrojo73: folds 
MikeVin100: raises 3900 to 4900
SYC55: folds 
Mateus at: calls 3900
*** FLOP *** [7s Qc 8c]
MikeVin100: checks 
Mateus at: bets 6000
MikeVin100: folds 
Uncalled bet (6000) returned to Mateus at
Mateus at collected 11700 from pot
*** SUMMARY ***
Total pot 11700 | Rake 0 
Board [7s Qc 8c]
Seat 1: SYC55 (big blind) folded before Flop
Seat 2: Mateus at collected (11700)
Seat 3: ordnasAA folded before Flop (didn't bet)
Seat 4: makko1616 folded before Flop (didn't bet)
Seat 5: hzane folded before Flop (didn't bet)
Seat 6: ramonsus folded before Flop (didn't bet)
Seat 7: snowfox568 folded before Flop (didn't bet)
Seat 8: pezrojo73 (button) folded before Flop (didn't bet)
Seat 9: MikeVin100 (small blind) folded on the Flop



PokerStars Hand #189158375256: Tournament #2361851754, 9000+1000 Hold'em No Limit - Level XXIII (500/1000) - 2018/07/25 21:28:29 ET
Table '2361851754 11' 9-max Seat #9 is the button
Seat 1: SYC55 (5984 in chips) 
Seat 2: Mateus at (37698 in chips) 
Seat 3: ordnasAA (6041 in chips) 
Seat 4: makko1616 (867 in chips) is sitting out
Seat 5: hzane (13430 in chips) 
Seat 6: ramonsus (19797 in chips) 
Seat 7: snowfox568 (2662 in chips) is sitting out
Seat 8: pezrojo73 (10595 in chips) 
Seat 9: MikeVin100 (43976 in chips) 
SYC55: posts the ante 100
Mateus at: posts the ante 100
ordnasAA: posts the ante 100
makko1616: posts the ante 100
hzane: posts the ante 100
ramonsus: posts the ante 100
snowfox568: posts the ante 100
pezrojo73: posts the ante 100
MikeVin100: posts the ante 100
SYC55: posts small blind 500
Mateus at: posts big blind 1000
*** HOLE CARDS ***
Dealt to hzane [Qh Th]
ordnasAA: folds 
makko1616: folds 
hzane: calls 1000
ramonsus: calls 1000
snowfox568: folds 
pezrojo73: raises 9495 to 10495 and is all-in
MikeVin100: folds 
SYC55: folds 
Mateus at: folds 
hzane: folds 
ramonsus: folds 
Uncalled bet (9495) returned to pezrojo73
pezrojo73 collected 5400 from pot
pezrojo73: doesn't show hand 
*** SUMMARY ***
Total pot 5400 | Rake 0 
Seat 1: SYC55 (small blind) folded before Flop
Seat 2: Mateus at (big blind) folded before Flop
Seat 3: ordnasAA folded before Flop (didn't bet)
Seat 4: makko1616 folded before Flop (didn't bet)
Seat 5: hzane folded before Flop
Seat 6: ramonsus folded before Flop
Seat 7: snowfox568 folded before Flop (didn't bet)
Seat 8: pezrojo73 collected (5400)
Seat 9: MikeVin100 (button) folded before Flop (didn't bet)



PokerStars Hand #189158384795: Tournament #2361851754, 9000+1000 Hold'em No Limit - Level XXIII (500/1000) - 2018/07/25 21:28:57 ET
Table '2361851754 11' 9-max Seat #1 is the button
Seat 1: SYC55 (5384 in chips) 
Seat 2: Mateus at (36598 in chips) 
Seat 4: makko1616 (767 in chips) is sitting out
Seat 5: hzane (12330 in chips) 
Seat 6: ramonsus (18697 in chips) 
Seat 7: snowfox568 (2562 in chips) is sitting out
Seat 8: pezrojo73 (14895 in chips) 
Seat 9: MikeVin100 (43876 in chips) 
SYC55: posts the ante 100
Mateus at: posts the ante 100
makko1616: posts the ante 100
hzane: posts the ante 100
ramonsus: posts the ante 100
snowfox568: posts the ante 100
pezrojo73: posts the ante 100
MikeVin100: posts the ante 100
Mateus at: posts small blind 500
makko1616: posts big blind 667 and is all-in
*** HOLE CARDS ***
Dealt to hzane [2h Ah]
hzane: calls 1000
ramonsus: calls 1000
snowfox568: folds 
pezrojo73: calls 1000
MikeVin100: folds 
SYC55: folds 
Mateus at: folds 
makko1616: folds 
*** FLOP *** [As Kd Th]
hzane: bets 2000
ramonsus: calls 2000
pezrojo73: calls 2000
*** TURN *** [As Kd Th] [Jd]
hzane: checks 
ramonsus: bets 12000
pezrojo73: calls 11795 and is all-in
hzane: folds 
Uncalled bet (205) returned to ramonsus
*** RIVER *** [As Kd Th Jd] [3d]
*** SHOW DOWN ***
ramonsus: shows [Qc 8c] (a straight, Ten to Ace)
pezrojo73: shows [Ts Js] (two pair, Jacks and Tens)
ramonsus collected 34557 from pot
pezrojo73 finished the tournament in 52nd place and received 27000.
makko1616 finished the tournament in 53rd place and received 27000.
*** SUMMARY ***
Total pot 34557 | Rake 0 
Board [As Kd Th Jd 3d]
Seat 1: SYC55 (button) folded before Flop (didn't bet)
Seat 2: Mateus at (small blind) folded before Flop
Seat 4: makko1616 (big blind) folded before Flop
Seat 5: hzane folded on the Turn
Seat 6: ramonsus showed [Qc 8c] and won (34557) with a straight, Ten to Ace
Seat 7: snowfox568 folded before Flop (didn't bet)
Seat 8: pezrojo73 showed [Ts Js] and lost with two pair, Jacks and Tens
Seat 9: MikeVin100 folded before Flop (didn't bet)



PokerStars Hand #189158404240: Tournament #2361851754, 9000+1000 Hold'em No Limit - Level XXIII (500/1000) - 2018/07/25 21:29:54 ET
Table '2361851754 11' 9-max Seat #2 is the button
Seat 1: SYC55 (5284 in chips) 
Seat 2: Mateus at (35998 in chips) 
Seat 5: hzane (9230 in chips) 
Seat 6: ramonsus (38359 in chips) 
Seat 7: snowfox568 (2462 in chips) is sitting out
Seat 9: MikeVin100 (43776 in chips) 
SYC55: posts the ante 100
Mateus at: posts the ante 100
hzane: posts the ante 100
ramonsus: posts the ante 100
snowfox568: posts the ante 100
MikeVin100: posts the ante 100
hzane: posts small blind 500
ramonsus: posts big blind 1000
*** HOLE CARDS ***
Dealt to hzane [Ah Ks]
snowfox568: folds 
MikeVin100: calls 1000
SYC55: folds 
Mateus at: calls 1000
hzane: raises 1000 to 2000
ramonsus: calls 1000
MikeVin100: calls 1000
Mateus at: calls 1000
*** FLOP *** [6s 7s As]
hzane: bets 1000
ramonsus: folds 
MikeVin100: folds 
Mateus at: folds 
Uncalled bet (1000) returned to hzane
hzane collected 8600 from pot
*** SUMMARY ***
Total pot 8600 | Rake 0 
Board [6s 7s As]
Seat 1: SYC55 folded before Flop (didn't bet)
Seat 2: Mateus at (button) folded on the Flop
Seat 5: hzane (small blind) collected (8600)
Seat 6: ramonsus (big blind) folded on the Flop
Seat 7: snowfox568 folded before Flop (didn't bet)
Seat 9: MikeVin100 folded on the Flop



PokerStars Hand #189158422651: Tournament #2361851754, 9000+1000 Hold'em No Limit - Level XXIV (600/1200) - 2018/07/25 21:30:47 ET
Table '2361851754 11' 9-max Seat #5 is the button
Seat 1: SYC55 (5184 in chips) 
Seat 2: Mateus at (33898 in chips) 
Seat 3: poker rana (4817 in chips) 
Seat 5: hzane (15730 in chips) 
Seat 6: ramonsus (36259 in chips) 
Seat 7: snowfox568 (2362 in chips) is sitting out
Seat 8: Volley562 (33530 in chips) 
Seat 9: MikeVin100 (41676 in chips) 
SYC55: posts the ante 120
Mateus at: posts the ante 120
poker rana: posts the ante 120
hzane: posts the ante 120
ramonsus: posts the ante 120
snowfox568: posts the ante 120
Volley562: posts the ante 120
MikeVin100: posts the ante 120
ramonsus: posts small blind 600
snowfox568: posts big blind 1200
*** HOLE CARDS ***
Dealt to hzane [Kc Ac]
Volley562: folds 
MikeVin100 is disconnected 
MikeVin100 has timed out while being disconnected
MikeVin100: folds 
SYC55: folds 
Mateus at: folds 
poker rana: folds 
hzane: calls 1200
ramonsus: calls 600
snowfox568: folds 
*** FLOP *** [6c Qh 7h]
ramonsus: checks 
hzane: bets 1200
ramonsus: folds 
Uncalled bet (1200) returned to hzane
hzane collected 4560 from pot
*** SUMMARY ***
Total pot 4560 | Rake 0 
Board [6c Qh 7h]
Seat 1: SYC55 folded before Flop (didn't bet)
Seat 2: Mateus at folded before Flop (didn't bet)
Seat 3: poker rana folded before Flop (didn't bet)
Seat 5: hzane (button) collected (4560)
Seat 6: ramonsus (small blind) folded on the Flop
Seat 7: snowfox568 (big blind) folded before Flop
Seat 8: Volley562 folded before Flop (didn't bet)
Seat 9: MikeVin100 folded before Flop (didn't bet)



PokerStars Hand #189158438984: Tournament #2361851754, 9000+1000 Hold'em No Limit - Level XXIV (600/1200) - 2018/07/25 21:31:34 ET
Table '2361851754 11' 9-max Seat #6 is the button
Seat 1: SYC55 (5064 in chips) 
Seat 2: Mateus at (33778 in chips) 
Seat 3: poker rana (4697 in chips) 
Seat 5: hzane (18970 in chips) 
Seat 6: ramonsus (34939 in chips) 
Seat 7: snowfox568 (1042 in chips) is sitting out
Seat 8: Volley562 (33410 in chips) 
Seat 9: MikeVin100 (41556 in chips) 
SYC55: posts the ante 120
Mateus at: posts the ante 120
poker rana: posts the ante 120
hzane: posts the ante 120
ramonsus: posts the ante 120
snowfox568: posts the ante 120
Volley562: posts the ante 120
MikeVin100: posts the ante 120
snowfox568: posts small blind 600
Volley562: posts big blind 1200
*** HOLE CARDS ***
Dealt to hzane [5c As]
MikeVin100: folds 
SYC55: folds 
Mateus at: calls 1200
poker rana: folds 
hzane: raises 1200 to 2400
ramonsus: folds 
snowfox568: folds 
Volley562: calls 1200
Mateus at: calls 1200
*** FLOP *** [2d Jh Qc]
Volley562: checks 
Mateus at: checks 
hzane: checks 
*** TURN *** [2d Jh Qc] [Ad]
Volley562: checks 
Mateus at has timed out
Mateus at: checks 
hzane: bets 1200
Volley562: calls 1200
Mateus at: folds 
*** RIVER *** [2d Jh Qc Ad] [8c]
Volley562: bets 12000
hzane: raises 3250 to 15250 and is all-in
Volley562: calls 3250
*** SHOW DOWN ***
hzane: shows [5c As] (a pair of Aces)
Volley562: shows [Ks 6d] (high card Ace)
hzane collected 41660 from pot
*** SUMMARY ***
Total pot 41660 | Rake 0 
Board [2d Jh Qc Ad 8c]
Seat 1: SYC55 folded before Flop (didn't bet)
Seat 2: Mateus at folded on the Turn
Seat 3: poker rana folded before Flop (didn't bet)
Seat 5: hzane showed [5c As] and won (41660) with a pair of Aces
Seat 6: ramonsus (button) folded before Flop (didn't bet)
Seat 7: snowfox568 (small blind) folded before Flop
Seat 8: Volley562 (big blind) showed [Ks 6d] and lost with high card Ace
Seat 9: MikeVin100 folded before Flop (didn't bet)



PokerStars Hand #189158466849: Tournament #2361851754, 9000+1000 Hold'em No Limit - Level XXIV (600/1200) - 2018/07/25 21:32:56 ET
Table '2361851754 11' 9-max Seat #7 is the button
Seat 1: SYC55 (4944 in chips) 
Seat 2: Mateus at (31258 in chips) 
Seat 3: poker rana (4577 in chips) 
Seat 4: notahaiku (1325 in chips) 
Seat 5: hzane (41660 in chips) 
Seat 6: ramonsus (34819 in chips) 
Seat 7: snowfox568 (322 in chips) is sitting out
Seat 8: Volley562 (14440 in chips) 
Seat 9: MikeVin100 (41436 in chips) 
SYC55: posts the ante 120
Mateus at: posts the ante 120
poker rana: posts the ante 120
notahaiku: posts the ante 120
hzane: posts the ante 120
ramonsus: posts the ante 120
snowfox568: posts the ante 120
Volley562: posts the ante 120
MikeVin100: posts the ante 120
Volley562: posts small blind 600
MikeVin100: posts big blind 1200
*** HOLE CARDS ***
Dealt to hzane [Th Td]
SYC55: folds 
Mateus at: calls 1200
poker rana: raises 1200 to 2400
notahaiku: calls 1205 and is all-in
hzane: raises 1200 to 3600
ramonsus: folds 
snowfox568: folds 
Volley562: folds 
MikeVin100: folds 
Mateus at: calls 2400
poker rana: raises 857 to 4457 and is all-in
hzane: calls 857
Mateus at: calls 857
*** FLOP *** [9d Js Tc]
Mateus at: checks 
hzane: bets 1200
Mateus at: calls 1200
*** TURN *** [9d Js Tc] [7c]
Mateus at: checks 
hzane: bets 1200
Mateus at: raises 10800 to 12000
hzane: calls 10800
*** RIVER *** [9d Js Tc 7c] [4h]
Mateus at: bets 13481 and is all-in
hzane: calls 13481
*** SHOW DOWN ***
Mateus at: shows [8d 4d] (a straight, Seven to Jack)
hzane: shows [Th Td] (three of a kind, Tens)
Mateus at collected 53362 from side pot-2 
poker rana: shows [Ah Kc] (high card Ace)
Mateus at collected 9756 from side pot-1 
notahaiku: shows [Ks 9c] (a pair of Nines)
Mateus at collected 7700 from main pot
poker rana finished the tournament in 40th place and received 30000.
notahaiku finished the tournament in 41st place and received 30000.
*** SUMMARY ***
Total pot 70818 Main pot 7700. Side pot-1 9756. Side pot-2 53362. | Rake 0 
Board [9d Js Tc 7c 4h]
Seat 1: SYC55 folded before Flop (didn't bet)
Seat 2: Mateus at showed [8d 4d] and won (70818) with a straight, Seven to Jack
Seat 3: poker rana showed [Ah Kc] and lost with high card Ace
Seat 4: notahaiku showed [Ks 9c] and lost with a pair of Nines
Seat 5: hzane showed [Th Td] and lost with three of a kind, Tens
Seat 6: ramonsus folded before Flop (didn't bet)
Seat 7: snowfox568 (button) folded before Flop (didn't bet)
Seat 8: Volley562 (small blind) folded before Flop
Seat 9: MikeVin100 (big blind) folded before Flop



PokerStars Hand #189158497531: Tournament #2361851754, 9000+1000 Hold'em No Limit - Level XXV (700/1400) - 2018/07/25 21:34:26 ET
Table '2361851754 11' 9-max Seat #8 is the button
Seat 1: SYC55 (4824 in chips) 
Seat 2: Mateus at (70818 in chips) 
Seat 5: hzane (10402 in chips) 
Seat 6: ramonsus (34699 in chips) 
Seat 7: snowfox568 (202 in chips) 
Seat 8: Volley562 (13720 in chips) 
Seat 9: MikeVin100 (40116 in chips) 
SYC55: posts the ante 140
Mateus at: posts the ante 140
hzane: posts the ante 140
ramonsus: posts the ante 140
snowfox568: posts the ante 140
Volley562: posts the ante 140
MikeVin100: posts the ante 140
MikeVin100: posts small blind 700
SYC55: posts big blind 1400
*** HOLE CARDS ***
Dealt to hzane [9d Td]
Mateus at: folds 
hzane: calls 1400
ramonsus: folds 
snowfox568: calls 62 and is all-in
Volley562: raises 12180 to 13580 and is all-in
MikeVin100: folds 
SYC55: folds 
hzane: folds 
Uncalled bet (12180) returned to Volley562
*** FLOP *** [7h Kd Jc]
*** TURN *** [7h Kd Jc] [7c]
*** RIVER *** [7h Kd Jc 7c] [5d]
*** SHOW DOWN ***
Volley562: shows [3h 3s] (two pair, Sevens and Threes)
Volley562 collected 4652 from side pot
snowfox568: shows [Th Ac] (a pair of Sevens)
Volley562 collected 1290 from main pot
snowfox568 finished the tournament in 38th place and received 30000.
*** SUMMARY ***
Total pot 5942 Main pot 1290. Side pot 4652. | Rake 0 
Board [7h Kd Jc 7c 5d]
Seat 1: SYC55 (big blind) folded before Flop
Seat 2: Mateus at folded before Flop (didn't bet)
Seat 5: hzane folded before Flop
Seat 6: ramonsus folded before Flop (didn't bet)
Seat 7: snowfox568 showed [Th Ac] and lost with a pair of Sevens
Seat 8: Volley562 (button) showed [3h 3s] and won (5942) with two pair, Sevens and Threes
Seat 9: MikeVin100 (small blind) folded before Flop



PokerStars Hand #189158506178: Tournament #2361851754, 9000+1000 Hold'em No Limit - Level XXV (700/1400) - 2018/07/25 21:34:52 ET
Table '2361851754 11' 9-max Seat #9 is the button
Seat 1: SYC55 (3284 in chips) 
Seat 2: Mateus at (70678 in chips) 
Seat 5: hzane (8862 in chips) 
Seat 6: ramonsus (34559 in chips) 
Seat 8: Volley562 (18122 in chips) 
Seat 9: MikeVin100 (39276 in chips) 
SYC55: posts the ante 140
Mateus at: posts the ante 140
hzane: posts the ante 140
ramonsus: posts the ante 140
Volley562: posts the ante 140
MikeVin100: posts the ante 140
SYC55: posts small blind 700
Mateus at: posts big blind 1400
*** HOLE CARDS ***
Dealt to hzane [Qs 6d]
hzane: folds 
ramonsus: folds 
Volley562: raises 1400 to 2800
MikeVin100: folds 
SYC55: raises 344 to 3144 and is all-in
Mateus at: calls 1744
Volley562: calls 344
*** FLOP *** [9s Kh 4d]
Mateus at: checks 
Volley562: bets 2800
Mateus at: folds 
Uncalled bet (2800) returned to Volley562
*** TURN *** [9s Kh 4d] [8s]
*** RIVER *** [9s Kh 4d 8s] [Jh]
*** SHOW DOWN ***
SYC55: shows [Td Kc] (a pair of Kings)
Volley562: shows [2h 3h] (high card King)
SYC55 collected 10272 from pot
*** SUMMARY ***
Total pot 10272 | Rake 0 
Board [9s Kh 4d 8s Jh]
Seat 1: SYC55 (small blind) showed [Td Kc] and won (10272) with a pair of Kings
Seat 2: Mateus at (big blind) folded on the Flop
Seat 5: hzane folded before Flop (didn't bet)
Seat 6: ramonsus folded before Flop (didn't bet)
Seat 8: Volley562 showed [2h 3h] and lost with high card King
Seat 9: MikeVin100 (button) folded before Flop (didn't bet)



PokerStars Hand #189158521585: Tournament #2361851754, 9000+1000 Hold'em No Limit - Level XXV (700/1400) - 2018/07/25 21:35:37 ET
Table '2361851754 11' 9-max Seat #1 is the button
Seat 1: SYC55 (10272 in chips) 
Seat 2: Mateus at (67394 in chips) 
Seat 5: hzane (8722 in chips) 
Seat 6: ramonsus (34419 in chips) 
Seat 7: SmallZ827 (3718 in chips) 
Seat 8: Volley562 (14838 in chips) 
Seat 9: MikeVin100 (39136 in chips) 
SYC55: posts the ante 140
Mateus at: posts the ante 140
hzane: posts the ante 140
ramonsus: posts the ante 140
SmallZ827: posts the ante 140
Volley562: posts the ante 140
MikeVin100: posts the ante 140
Mateus at: posts small blind 700
hzane: posts big blind 1400
*** HOLE CARDS ***
Dealt to hzane [7d 3s]
ramonsus: folds 
SmallZ827: folds 
Volley562: raises 1400 to 2800
MikeVin100: folds 
SYC55: folds 
Mateus at: folds 
hzane: folds 
Uncalled bet (1400) returned to Volley562
Volley562 collected 4480 from pot
Volley562: doesn't show hand 
*** SUMMARY ***
Total pot 4480 | Rake 0 
Seat 1: SYC55 (button) folded before Flop (didn't bet)
Seat 2: Mateus at (small blind) folded before Flop
Seat 5: hzane (big blind) folded before Flop
Seat 6: ramonsus folded before Flop (didn't bet)
Seat 7: SmallZ827 folded before Flop (didn't bet)
Seat 8: Volley562 collected (4480)
Seat 9: MikeVin100 folded before Flop (didn't bet)



PokerStars Hand #189158531295: Tournament #2361851754, 9000+1000 Hold'em No Limit - Level XXV (700/1400) - 2018/07/25 21:36:05 ET
Table '2361851754 11' 9-max Seat #2 is the button
Seat 1: SYC55 (10132 in chips) 
Seat 2: Mateus at (66554 in chips) 
Seat 5: hzane (7182 in chips) 
Seat 6: ramonsus (34279 in chips) 
Seat 7: SmallZ827 (3578 in chips) 
Seat 8: Volley562 (17778 in chips) 
Seat 9: MikeVin100 (38996 in chips) 
SYC55: posts the ante 140
Mateus at: posts the ante 140
hzane: posts the ante 140
ramonsus: posts the ante 140
SmallZ827: posts the ante 140
Volley562: posts the ante 140
MikeVin100: posts the ante 140
hzane: posts small blind 700
ramonsus: posts big blind 1400
*** HOLE CARDS ***
Dealt to hzane [4s Kd]
SmallZ827: folds 
Volley562: folds 
MikeVin100: calls 1400
SYC55: calls 1400
Mateus at: folds 
hzane: folds 
ramonsus: checks 
*** FLOP *** [4d 5s 6h]
ramonsus: checks 
MikeVin100: checks 
SYC55: checks 
*** TURN *** [4d 5s 6h] [2h]
ramonsus: bets 1400
MikeVin100: folds 
SYC55: folds 
Uncalled bet (1400) returned to ramonsus
ramonsus collected 5880 from pot
*** SUMMARY ***
Total pot 5880 | Rake 0 
Board [4d 5s 6h 2h]
Seat 1: SYC55 folded on the Turn
Seat 2: Mateus at (button) folded before Flop (didn't bet)
Seat 5: hzane (small blind) folded before Flop
Seat 6: ramonsus (big blind) collected (5880)
Seat 7: SmallZ827 folded before Flop (didn't bet)
Seat 8: Volley562 folded before Flop (didn't bet)
Seat 9: MikeVin100 folded on the Turn



PokerStars Hand #189158542176: Tournament #2361851754, 9000+1000 Hold'em No Limit - Level XXVI (800/1600) - 2018/07/25 21:36:37 ET
Table '2361851754 11' 9-max Seat #5 is the button
Seat 1: SYC55 (8592 in chips) 
Seat 2: Mateus at (66414 in chips) 
Seat 3: equeir88 (57366 in chips) 
Seat 4: SmokeyLMB (10260 in chips) 
Seat 5: hzane (6342 in chips) 
Seat 6: ramonsus (38619 in chips) 
Seat 7: SmallZ827 (3438 in chips) 
Seat 8: Volley562 (17638 in chips) 
Seat 9: MikeVin100 (37456 in chips) 
SYC55: posts the ante 160
Mateus at: posts the ante 160
equeir88: posts the ante 160
SmokeyLMB: posts the ante 160
hzane: posts the ante 160
ramonsus: posts the ante 160
SmallZ827: posts the ante 160
Volley562: posts the ante 160
MikeVin100: posts the ante 160
ramonsus: posts small blind 800
SmallZ827: posts big blind 1600
*** HOLE CARDS ***
Dealt to hzane [Qs 8c]
Volley562: folds 
MikeVin100: raises 5440 to 7040
SYC55: folds 
Mateus at: folds 
equeir88: calls 7040
SmokeyLMB: raises 3060 to 10100 and is all-in
hzane: folds 
ramonsus: folds 
SmallZ827: folds 
MikeVin100: calls 3060
equeir88: calls 3060
*** FLOP *** [7c Kc 3s]
MikeVin100: checks 
equeir88: checks 
*** TURN *** [7c Kc 3s] [6s]
MikeVin100: checks 
equeir88: checks 
*** RIVER *** [7c Kc 3s 6s] [Jd]
MikeVin100: checks 
equeir88: checks 
*** SHOW DOWN ***
MikeVin100: shows [5h 5c] (a pair of Fives)
equeir88: mucks hand 
SmokeyLMB: mucks hand 
MikeVin100 collected 34140 from pot
SmokeyLMB finished the tournament in 35th place and received 32000.
*** SUMMARY ***
Total pot 34140 | Rake 0 
Board [7c Kc 3s 6s Jd]
Seat 1: SYC55 folded before Flop (didn't bet)
Seat 2: Mateus at folded before Flop (didn't bet)
Seat 3: equeir88 mucked [Ac Qc]
Seat 4: SmokeyLMB mucked [Qh Ah]
Seat 5: hzane (button) folded before Flop (didn't bet)
Seat 6: ramonsus (small blind) folded before Flop
Seat 7: SmallZ827 (big blind) folded before Flop
Seat 8: Volley562 folded before Flop (didn't bet)
Seat 9: MikeVin100 showed [5h 5c] and won (34140) with a pair of Fives



PokerStars Hand #189158560871: Tournament #2361851754, 9000+1000 Hold'em No Limit - Level XXVI (800/1600) - 2018/07/25 21:37:31 ET
Table '2361851754 11' 9-max Seat #6 is the button
Seat 1: SYC55 (8432 in chips) 
Seat 2: Mateus at (66254 in chips) 
Seat 3: equeir88 (47106 in chips) 
Seat 5: hzane (6182 in chips) 
Seat 6: ramonsus (37659 in chips) 
Seat 7: SmallZ827 (1678 in chips) 
Seat 8: Volley562 (17478 in chips) 
Seat 9: MikeVin100 (61336 in chips) 
SYC55: posts the ante 160
Mateus at: posts the ante 160
equeir88: posts the ante 160
hzane: posts the ante 160
ramonsus: posts the ante 160
SmallZ827: posts the ante 160
Volley562: posts the ante 160
MikeVin100: posts the ante 160
SmallZ827: posts small blind 800
Volley562: posts big blind 1600
*** HOLE CARDS ***
Dealt to hzane [Jc Kh]
MikeVin100: raises 5280 to 6880
SYC55: folds 
Mateus at: folds 
equeir88: folds 
hzane: folds 
ramonsus: folds 
SmallZ827: calls 718 and is all-in
Volley562: folds 
Uncalled bet (5280) returned to MikeVin100
*** FLOP *** [Kc Jh 8c]
*** TURN *** [Kc Jh 8c] [9d]
*** RIVER *** [Kc Jh 8c 9d] [Td]
*** SHOW DOWN ***
MikeVin100: shows [As 9s] (a pair of Nines)
MikeVin100 collected 164 from side pot
SmallZ827: shows [Ks Tc] (two pair, Kings and Tens)
SmallZ827 collected 5834 from main pot
*** SUMMARY ***
Total pot 5998 Main pot 5834. Side pot 164. | Rake 0 
Board [Kc Jh 8c 9d Td]
Seat 1: SYC55 folded before Flop (didn't bet)
Seat 2: Mateus at folded before Flop (didn't bet)
Seat 3: equeir88 folded before Flop (didn't bet)
Seat 5: hzane folded before Flop (didn't bet)
Seat 6: ramonsus (button) folded before Flop (didn't bet)
Seat 7: SmallZ827 (small blind) showed [Ks Tc] and won (5834) with two pair, Kings and Tens
Seat 8: Volley562 (big blind) folded before Flop
Seat 9: MikeVin100 showed [As 9s] and won (164) with a pair of Nines



PokerStars Hand #189158571604: Tournament #2361851754, 9000+1000 Hold'em No Limit - Level XXVI (800/1600) - 2018/07/25 21:38:02 ET
Table '2361851754 11' 9-max Seat #7 is the button
Seat 1: SYC55 (8272 in chips) 
Seat 2: Mateus at (66094 in chips) 
Seat 3: equeir88 (46946 in chips) 
Seat 5: hzane (6022 in chips) 
Seat 6: ramonsus (37499 in chips) 
Seat 7: SmallZ827 (5834 in chips) 
Seat 8: Volley562 (15718 in chips) 
Seat 9: MikeVin100 (59740 in chips) 
SYC55: posts the ante 160
Mateus at: posts the ante 160
equeir88: posts the ante 160
hzane: posts the ante 160
ramonsus: posts the ante 160
SmallZ827: posts the ante 160
Volley562: posts the ante 160
MikeVin100: posts the ante 160
Volley562: posts small blind 800
MikeVin100: posts big blind 1600
*** HOLE CARDS ***
Dealt to hzane [Js Kd]
SYC55: folds 
Mateus at: calls 1600
equeir88: calls 1600
hzane: raises 1600 to 3200
ramonsus: folds 
SmallZ827: folds 
Volley562: folds 
MikeVin100: folds 
Mateus at: calls 1600
equeir88: calls 1600
*** FLOP *** [7c 2h 3d]
Mateus at: checks 
equeir88: checks 
hzane: checks 
*** TURN *** [7c 2h 3d] [4h]
Mateus at: checks 
equeir88: checks 
hzane: checks 
*** RIVER *** [7c 2h 3d 4h] [6c]
Mateus at: checks 
equeir88: checks 
hzane: bets 2662 and is all-in
Mateus at: folds 
equeir88: folds 
Uncalled bet (2662) returned to hzane
hzane collected 13280 from pot
*** SUMMARY ***
Total pot 13280 | Rake 0 
Board [7c 2h 3d 4h 6c]
Seat 1: SYC55 folded before Flop (didn't bet)
Seat 2: Mateus at folded on the River
Seat 3: equeir88 folded on the River
Seat 5: hzane collected (13280)
Seat 6: ramonsus folded before Flop (didn't bet)
Seat 7: SmallZ827 (button) folded before Flop (didn't bet)
Seat 8: Volley562 (small blind) folded before Flop
Seat 9: MikeVin100 (big blind) folded before Flop



PokerStars Hand #189158600145: Tournament #2361851754, 9000+1000 Hold'em No Limit - Level XXVI (800/1600) - 2018/07/25 21:39:13 ET
Table '2361851754 11' 9-max Seat #8 is the button
Seat 1: SYC55 (8112 in chips) 
Seat 2: Mateus at (62734 in chips) 
Seat 3: equeir88 (43586 in chips) 
Seat 5: hzane (15942 in chips) 
Seat 6: ramonsus (37339 in chips) 
Seat 8: Volley562 (14758 in chips) 
Seat 9: MikeVin100 (57980 in chips) 
SYC55: posts the ante 160
Mateus at: posts the ante 160
equeir88: posts the ante 160
hzane: posts the ante 160
ramonsus: posts the ante 160
Volley562: posts the ante 160
MikeVin100: posts the ante 160
MikeVin100: posts small blind 800
SYC55: posts big blind 1600
*** HOLE CARDS ***
Dealt to hzane [5h 4s]
Mateus at has timed out
Mateus at: folds 
equeir88: calls 1600
hzane: folds 
ramonsus: folds 
Volley562: raises 12998 to 14598 and is all-in
MikeVin100: folds 
SYC55: folds 
equeir88: folds 
Uncalled bet (12998) returned to Volley562
Volley562 collected 6720 from pot
Volley562: doesn't show hand 
*** SUMMARY ***
Total pot 6720 | Rake 0 
Seat 1: SYC55 (big blind) folded before Flop
Seat 2: Mateus at folded before Flop (didn't bet)
Seat 3: equeir88 folded before Flop
Seat 5: hzane folded before Flop (didn't bet)
Seat 6: ramonsus folded before Flop (didn't bet)
Seat 8: Volley562 (button) collected (6720)
Seat 9: MikeVin100 (small blind) folded before Flop



PokerStars Hand #189158616615: Tournament #2361851754, 9000+1000 Hold'em No Limit - Level XXVII (1000/2000) - 2018/07/25 21:40:02 ET
Table '2361851754 11' 9-max Seat #9 is the button
Seat 1: SYC55 (6352 in chips) 
Seat 2: Mateus at (62574 in chips) 
Seat 3: equeir88 (41826 in chips) 
Seat 4: pokeritoAAAA (4505 in chips) 
Seat 5: hzane (15782 in chips) 
Seat 6: ramonsus (37179 in chips) 
Seat 7: Tim4475 (37184 in chips) 
Seat 8: Volley562 (19718 in chips) 
Seat 9: MikeVin100 (57020 in chips) 
SYC55: posts the ante 200
Mateus at: posts the ante 200
equeir88: posts the ante 200
pokeritoAAAA: posts the ante 200
hzane: posts the ante 200
ramonsus: posts the ante 200
Tim4475: posts the ante 200
Volley562: posts the ante 200
MikeVin100: posts the ante 200
SYC55: posts small blind 1000
Mateus at: posts big blind 2000
*** HOLE CARDS ***
Dealt to hzane [8d 6s]
equeir88: folds 
pokeritoAAAA: raises 2305 to 4305 and is all-in
hzane: folds 
ramonsus: calls 4305
Tim4475: calls 4305
Volley562: folds 
MikeVin100: folds 
SYC55: folds 
Mateus at: folds 
*** FLOP *** [Jd Kc Ts]
ramonsus: bets 2000
Tim4475: calls 2000
*** TURN *** [Jd Kc Ts] [5c]
ramonsus: checks 
Tim4475: checks 
*** RIVER *** [Jd Kc Ts 5c] [2h]
ramonsus: bets 4000
Tim4475: folds 
Uncalled bet (4000) returned to ramonsus
*** SHOW DOWN ***
ramonsus: shows [9c Ad] (high card Ace)
ramonsus collected 4000 from side pot
pokeritoAAAA: shows [Qd 7d] (high card King)
ramonsus collected 17715 from main pot
pokeritoAAAA finished the tournament in 25th place and received 35000.
*** SUMMARY ***
Total pot 21715 Main pot 17715. Side pot 4000. | Rake 0 
Board [Jd Kc Ts 5c 2h]
Seat 1: SYC55 (small blind) folded before Flop
Seat 2: Mateus at (big blind) folded before Flop
Seat 3: equeir88 folded before Flop (didn't bet)
Seat 4: pokeritoAAAA showed [Qd 7d] and lost with high card King
Seat 5: hzane folded before Flop (didn't bet)
Seat 6: ramonsus showed [9c Ad] and won (21715) with high card Ace
Seat 7: Tim4475 folded on the River
Seat 8: Volley562 folded before Flop (didn't bet)
Seat 9: MikeVin100 (button) folded before Flop (didn't bet)



PokerStars Hand #189158631663: Tournament #2361851754, 9000+1000 Hold'em No Limit - Level XXVII (1000/2000) - 2018/07/25 21:40:46 ET
Table '2361851754 11' 9-max Seat #1 is the button
Seat 1: SYC55 (5152 in chips) 
Seat 2: Mateus at (60374 in chips) 
Seat 3: equeir88 (41626 in chips) 
Seat 5: hzane (15582 in chips) 
Seat 6: ramonsus (52389 in chips) 
Seat 7: Tim4475 (30679 in chips) 
Seat 8: Volley562 (19518 in chips) 
Seat 9: MikeVin100 (56820 in chips) 
SYC55: posts the ante 200
Mateus at: posts the ante 200
equeir88: posts the ante 200
hzane: posts the ante 200
ramonsus: posts the ante 200
Tim4475: posts the ante 200
Volley562: posts the ante 200
MikeVin100: posts the ante 200
Mateus at: posts small blind 1000
equeir88: posts big blind 2000
*** HOLE CARDS ***
Dealt to hzane [7s 7d]
hzane: calls 2000
ramonsus: folds 
Tim4475: folds 
Volley562: raises 4000 to 6000
MikeVin100: folds 
SYC55: folds 
Mateus at: calls 5000
equeir88: calls 4000
hzane: calls 4000
*** FLOP *** [9c 9d Ad]
Mateus at: checks 
equeir88: checks 
hzane: checks 
Volley562: bets 13318 and is all-in
Mateus at: folds 
equeir88: folds 
hzane: calls 9382 and is all-in
Uncalled bet (3936) returned to Volley562
*** TURN *** [9c 9d Ad] [6h]
*** RIVER *** [9c 9d Ad 6h] [Js]
*** SHOW DOWN ***
hzane: shows [7s 7d] (two pair, Nines and Sevens)
Volley562: shows [Kc As] (two pair, Aces and Nines)
Volley562 collected 44364 from pot
hzane finished the tournament in 23rd place and received 35000.
*** SUMMARY ***
Total pot 44364 | Rake 0 
Board [9c 9d Ad 6h Js]
Seat 1: SYC55 (button) folded before Flop (didn't bet)
Seat 2: Mateus at (small blind) folded on the Flop
Seat 3: equeir88 (big blind) folded on the Flop
Seat 5: hzane showed [7s 7d] and lost with two pair, Nines and Sevens
Seat 6: ramonsus folded before Flop (didn't bet)
Seat 7: Tim4475 folded before Flop (didn't bet)
Seat 8: Volley562 showed [Kc As] and won (44364) with two pair, Aces and Nines
Seat 9: MikeVin100 folded before Flop (didn't bet)



